가감	ㄱㅏㄱㅏㅁ	더하거나 뺌.
가게	ㄱㅏㄱㅓㅣ	작은 규모로 물건을 펼쳐 놓고 파는 집.
가격	ㄱㅏㄱㅕㄱ	손이나 주먹, 몽둥이 등으로 치거나 때림.
가결	ㄱㅏㄱㅕㄹ	회의에 제출된 안건을 좋다고 인정하여 결정함.
가계	ㄱㅏㄱㅕㅣ	조상에서부터 후손으로 이어지는 한 집안.
가곡	ㄱㅏㄱㅗㄱ	시를 피리, 가야금, 거문고 등 전통 악기에 맞춰서 노래하는 한국의 전통 성악곡.
가공	ㄱㅏㄱㅗㅇ	기술이나 힘 등을 이용해 원료나 재료를 새로운 제품으로 만듦.
가극	ㄱㅏㄱㅡㄱ	대사를 음악 연주에 맞추어 노래로 부르는 서양식 연극.
가난	ㄱㅏㄴㅏㄴ	돈이 없어서 생활이 어려움. 또는 그런 상태.
가늠	ㄱㅏㄴㅡㅁ	목표나 기준 등에 맞는지 안 맞는지를 살핌. 또는 살피는 목표나 기준.
가능	ㄱㅏㄴㅡㅇ	할 수 있거나 될 수 있음.
가닥	ㄱㅏㄷㅏㄱ	하나의 덩어리나 묶음에서 풀리거나 갈라져 나온 긴 줄.
가담	ㄱㅏㄷㅏㅁ	한편이 되어 일을 하거나 도움.
가동	ㄱㅏㄷㅗㅇ	기계 등이 움직여 일함. 또는 기계 등을 움직여 일하게 함.
가락	ㄱㅏㄹㅏㄱ	물레로 실을 만들 때 실이 감기는 쇠로 된 꼬챙이. 또는 그 꼬챙이에 감긴 실의 뭉치.
가래	ㄱㅏㄹㅏㅣ	떡이나 엿 등을 둥근 모양으로 길게 늘여 만든 토막.
가량	ㄱㅏㄹㅑㅇ	어느 정도가 될지 미리 짐작함.
가름	ㄱㅏㄹㅡㅁ	서로 나누어 따로따로 되게 함.
가망	ㄱㅏㅁㅏㅇ	바라는 대로 이루어질 가능성이나 희망.
가면	ㄱㅏㅁㅕㄴ	얼굴을 감추거나 다르게 꾸미기 위하여 종이, 나무, 흙 등으로 만들어 얼굴에 쓰는 물건.
가명	ㄱㅏㅁㅕㅇ	실제 자기 이름이 아닌 가짜 이름.
가문	ㄱㅏㅁㅜㄴ	한 조상으로부터 이어져 내려오는 집안. 또는 그 사회적 지위.
가뭄	ㄱㅏㅁㅜㅁ	오랫동안 비가 오지 않는 날씨.
가발	ㄱㅏㅂㅏㄹ	진짜 머리카락처럼 만들어 머리에 쓰거나 붙이는 가짜 머리카락.
가방	ㄱㅏㅂㅏㅇ	물건을 넣어 손에 들거나 어깨에 멜 수 있게 만든 것.
가법	ㄱㅏㅂㅓㅂ	한 집안에서 지켜야 할 규범이나 법도.
가변	ㄱㅏㅂㅕㄴ	형태나 성질이 바뀌거나 달라질 수 있음. 또는 형태나 성질을 바꾸거나 달라지게 할 수 있음.
가봉	ㄱㅏㅂㅗㅇ	서아프리카에 있는 나라. 주요 생산물로는 마호가니, 코코아, 석유, 우라늄 등이 있다. 주요 언어는 프랑스어이고 수도는 리브르빌이다.
가불	ㄱㅏㅂㅜㄹ	받기로 한 임금이나 용돈 등을 미리 받음.
가산	ㄱㅏㅅㅏㄴ	더하여 셈함.
가상	ㄱㅏㅅㅏㅇ	사실이 아닌 것을 지어내어 사실처럼 생각함.
가설	ㄱㅏㅅㅓㄹ	전깃줄, 전화선, 다리 등의 시설을 설치함.
가성	ㄱㅏㅅㅓㅇ	일부러 꾸며 낸 목소리.
가세	ㄱㅏㅅㅓㅣ	함께하여 힘을 보탬.
가속	ㄱㅏㅅㅗㄱ	속도를 높임. 또는 그 속도.
가슴	ㄱㅏㅅㅡㅁ	인간이나 동물의 목과 배 사이에 있는 몸의 앞 부분.
가식	ㄱㅏㅅㅣㄱ	말이나 행동을 거짓으로 꾸밈.
가십	ㄱㅏㅅㅣㅂ	흥미를 위해 개인의 소문이나 험담 등을 다룬 기사 또는 그런 이야기.
가업	ㄱㅏㅇㅓㅂ	한 집안에서 대대로 이어서 하는 사업.
가열	ㄱㅏㅇㅕㄹ	어떤 물질에 뜨거운 열을 가함.
가옥	ㄱㅏㅇㅗㄱ	사람이 사는 집.
가외	ㄱㅏㅇㅗㅣ	일정한 기준이나 한도에 더한 것.
가용	ㄱㅏㅇㅛㅇ	사용할 수 있음.
가운	ㄱㅏㅇㅜㄴ	집안의 운수.
가위	ㄱㅏㅇㅜㅣ	종이나 천, 머리카락 등을 자르는 도구.
가을	ㄱㅏㅇㅡㄹ	네 계절 중의 하나로 여름과 겨울 사이의 계절.
가입	ㄱㅏㅇㅣㅂ	단체에 들어가거나 상품 및 서비스를 받기 위해 계약을 함.
가작	ㄱㅏㅈㅏㄱ	매우 뛰어난 작품.
가장	ㄱㅏㅈㅏㅇ	한 가족을 대표하고 책임지는 사람. 주로 집안의 남자 어른.
가재	ㄱㅏㅈㅏㅣ	게와 새우의 중간 모양으로 껍데기가 단단하고 큰 집게발을 포함한 다섯 쌍의 발이 있으며, 맑은 물에 사는 동물.
가전	ㄱㅏㅈㅓㄴ	가정에서 사용하는 전기 기구.
가정	ㄱㅏㅈㅓㅇ	한 가족으로 이루어진 공동체나 그들이 생활하는 집.
가제	ㄱㅏㅈㅓㅣ	진짜 제목을 만들기 전에 임시로 만든 제목.
가족	ㄱㅏㅈㅗㄱ	주로 한 집에 모여 살고 결혼이나 부모, 자식, 형제 등의 관계로 이루어진 사람들의 집단. 또는 그 구성원.
가죽	ㄱㅏㅈㅜㄱ	사람이나 동물의 몸을 싸고 있는 껍질.
가중	ㄱㅏㅈㅜㅇ	책임이나 부담 등이 더 무겁고 커지는 것.
가짜	ㄱㅏㅈㅈㅏ	진짜처럼 꾸몄지만 진짜가 아닌 것.
가창	ㄱㅏㅊㅏㅇ	노래를 부름.
가축	ㄱㅏㅊㅜㄱ	사람이 생활에 도움을 얻으려고 집에서 기르는 짐승.
가출	ㄱㅏㅊㅜㄹ	가정을 버리고 집을 나가서 돌아오지 않음.
가친	ㄱㅏㅊㅣㄴ	(높이는 말로) 자기의 아버지.
가칭	ㄱㅏㅊㅣㅇ	임시로 이름을 지어 부름. 또는 그런 이름.
가탈	ㄱㅏㅌㅏㄹ	어떤 일에 방해가 되는 것.
가통	ㄱㅏㅌㅗㅇ	집안의 계통이나 전통.
가판	ㄱㅏㅍㅏㄴ	인쇄하기 전에 인쇄할 판을 인쇄기 위에 페이지 순서대로 정리하는 것.
가풍	ㄱㅏㅍㅜㅇ	한 집안 대대로 지켜온 풍습이나 생활 규범.
가필	ㄱㅏㅍㅣㄹ	글이나 문서를 부분적으로 고쳐 씀.
가학	ㄱㅏㅎㅏㄱ	심하고 잔인하게 괴롭힘.
가해	ㄱㅏㅎㅏㅣ	물리적으로나 정신적으로 다른 사람에게 해를 줌.
가훈	ㄱㅏㅎㅜㄴ	한 집안의 자손들에게 윤리적 기준이 되는 가르침.
각고	ㄱㅏㄱㄱㅗ	무엇을 이루기 위해 어려움을 견디며 무척 힘을 씀.
각기	ㄱㅏㄱㄱㅣ	각각의 사람. 또는 각각의 것.
각도	ㄱㅏㄱㄷㅗ	같은 지점에서 시작되는 두 개의 직선이나 평면이 벌어진 정도.
각료	ㄱㅏㄱㄹㅛ	내각을 구성하는 장관.
각부	ㄱㅏㄱㅂㅜ	하나의 단위를 이루는 각각의 부분.
각서	ㄱㅏㄱㅅㅓ	상대방에게 약속을 지키겠다는 내용을 적은 문서.
각시	ㄱㅏㄱㅅㅣ	갓 결혼한 젊은 여자.
각오	ㄱㅏㄱㅇㅗ	앞으로 겪을 힘든 일에 대한 마음의 준비.
각자	ㄱㅏㄱㅈㅏ	각각의 사람. 또는 각각 자기 자신.
각주	ㄱㅏㄱㅈㅜ	글의 본문 가운데 어떤 부분의 뜻을 보충하려고 아래쪽에 따로 덧붙인 설명.
각지	ㄱㅏㄱㅈㅣ	여러 지역.
각처	ㄱㅏㄱㅊㅓ	여러 곳.
각파	ㄱㅏㄱㅍㅏ	각각의 부류.
각하	ㄱㅏㄱㅎㅏ	법에서 소장이나 신청을 거절함.
간교	ㄱㅏㄴㄱㅛ	자기의 이익을 위해 남을 속이고 해치려는 나쁜 꾀. 또는 그러한 꾀를 부리는 것.
간부	ㄱㅏㄴㅂㅜ	기관이나 조직에서 핵심적인 위치에 있는 사람.
간사	ㄱㅏㄴㅅㅏ	다른 꿍꿍이가 있어서 거짓으로 남의 비위를 맞추려는 성질.
간수	ㄱㅏㄴㅅㅜ	물건을 잘 보관함.
간여	ㄱㅏㄴㅇㅕ	남의 일에 끼어들어 참견함.
간이	ㄱㅏㄴㅇㅣ	기본적인 것만을 갖추어 간단하고 편리함.
간조	ㄱㅏㄴㅈㅗ	바다에서 바닷물이 빠져나가 바닷물의 높이가 가장 낮아진 상태.
간주	ㄱㅏㄴㅈㅜ	무엇이 어떠하다고 생각되거나 여겨짐.
간지	ㄱㅏㄴㅈㅣ	동양에서 십간과 십이지를 조합하여 만든 육십 개의 순서.
간파	ㄱㅏㄴㅍㅏ	겉으로 드러나지 않은 점을 꿰뚫어 알아차림.
간호	ㄱㅏㄴㅎㅗ	아픈 사람을 보살핌.
갈구	ㄱㅏㄹㄱㅜ	무엇을 간절히 바라고 원함.
갈기	ㄱㅏㄹㄱㅣ	말이나 사자 등의 목과 등에 난 긴 털.
갈비	ㄱㅏㄹㅂㅣ	음식의 재료로 쓰이는 소, 돼지, 닭 등의 가슴뼈와 거기에 붙은 살. 또는 그것으로 만든 음식.
갈이	ㄱㅏㄹㅇㅣ	낡거나 못 쓰게 된 부분을 새것으로 바꾸는 일.
갈치	ㄱㅏㄹㅊㅣ	길고 납작한 모양의 은백색의 바닷물고기.
갈피	ㄱㅏㄹㅍㅣ	겹쳐 있거나 포개져 있는 물건의 하나하나의 사이.
감기	ㄱㅏㅁㄱㅣ	보통 기침, 콧물, 두통, 오한의 증상이 있는, 전염성이 있는 병.
감도	ㄱㅏㅁㄷㅗ	자극에 대해 느끼는 정도.
감리	ㄱㅏㅁㄹㅣ	건축이나 공사 등을 감독하고 관리함.
감사	ㄱㅏㅁㅅㅏ	고맙게 여김. 또는 그런 마음.
감소	ㄱㅏㅁㅅㅗ	양이나 수가 줄어듦. 또는 양이나 수를 줄임.
감수	ㄱㅏㅁㅅㅜ	괴롭고 힘든 일을 달갑게 받아들임.
감시	ㄱㅏㅁㅅㅣ	사람을 단속하거나 상황을 통제하기 위하여 주의 깊게 지켜봄.
감자	ㄱㅏㅁㅈㅏ	껍질은 연한 갈색이며 속은 연한 노란색인, 땅속에서 자라는 둥근 덩이 모양의 줄기.
감주	ㄱㅏㅁㅈㅜ	엿기름 우린 물에 밥을 넣어 삭힌 후 설탕을 넣고 끓여 만드는, 단맛의 한국 전통 음료.
감지	ㄱㅏㅁㅈㅣ	느끼어 앎.
감초	ㄱㅏㅁㅊㅗ	한방 재료로 널리 쓰이는 단맛의 풀. 또는 그 뿌리.
감투	ㄱㅏㅁㅌㅜ	(옛날에) 머리에 쓰던 말총, 가죽, 헝겊 등으로 만든 작은 모자.
감호	ㄱㅏㅁㅎㅗ	감독하고 보호함.
갑부	ㄱㅏㅂㅂㅜ	대단한 큰 부자.
갑주	ㄱㅏㅂㅈㅜ	갑옷과 투구.
강가	ㄱㅏㅇㄱㅏ	강 가장자리의 땅이나 그 근처.
강구	ㄱㅏㅇㄱㅜ	어떤 문제를 해결할 방법을 찾음.
강도	ㄱㅏㅇㄷㅗ	쇠붙이 등의 단단하고 센 정도.
강보	ㄱㅏㅇㅂㅗ	어린 아이를 업을 때 사용하는 작은 이불.
강사	ㄱㅏㅇㅅㅏ	강연회에서 강연을 하는 사람.
강수	ㄱㅏㅇㅅㅜ	정도가 지나친 강력한 방법.
강시	ㄱㅏㅇㅅㅣ	얼어 죽은 시체.
강요	ㄱㅏㅇㅇㅛ	어떤 일을 강제로 요구함.
강우	ㄱㅏㅇㅇㅜ	비가 내리는 것.
강자	ㄱㅏㅇㅈㅏ	힘이나 세력이 강한 자.
강조	ㄱㅏㅇㅈㅗ	어떤 것을 특히 두드러지게 하거나 강하게 주장함.
강타	ㄱㅏㅇㅌㅏ	세게 침.
강토	ㄱㅏㅇㅌㅗ	나라 안의 땅.
강하	ㄱㅏㅇㅎㅏ	강과 하천.
강호	ㄱㅏㅇㅎㅗ	강과 호수.
개가	ㄱㅏㅣㄱㅏ	결혼했던 여자가 남편과 사별하거나 이혼한 후 다른 남자와 다시 결혼함.
개교	ㄱㅏㅣㄱㅛ	학교를 세우고 운영을 시작함.
개그	ㄱㅏㅣㄱㅡ	연극이나 텔레비전 프로그램 등에서 우스운 말이나 행동으로 사람을 웃기는 일.
개미	ㄱㅏㅣㅁㅣ	주로 기어 다니며 땅 속에 굴을 파고 떼를 지어 사는, 작고 허리가 가는 곤충.
개비	ㄱㅏㅣㅂㅣ	일정하게 가늘고 짤막하게 만든 물건.
개수	ㄱㅏㅣㅅㅜ	하나씩 세는 물건의 수.
개시	ㄱㅏㅣㅅㅣ	시장을 처음 열어 물건을 팔고 사기 시작함.
개요	ㄱㅏㅣㅇㅛ	전체 내용 중에서 주요 내용을 뽑아 간략히 정리한 것.
개조	ㄱㅏㅣㅈㅗ	고쳐 새롭게 만들거나 바꿈.
개표	ㄱㅏㅣㅍㅛ	차표나 입장권 등을 입구에서 검사함.
거개	ㄱㅓㄱㅏㅣ	거의 대부분.
거국	ㄱㅓㄱㅜㄱ	온 나라.
거금	ㄱㅓㄱㅡㅁ	아주 많은 돈.
거대	ㄱㅓㄷㅏㅣ	엄청나게 큼.
거덜	ㄱㅓㄷㅓㄹ	재산이나 살림이 거의 없어지는 것.
거동	ㄱㅓㄷㅗㅇ	몸을 움직임. 또는 그러한 태도나 행동.
거들	ㄱㅓㄷㅡㄹ	아랫배를 누르고 허리를 조임으로써 몸매를 날씬하게 보이도록 하는 여자의 아랫도리 속옷.
거래	ㄱㅓㄹㅏㅣ	돈이나 물건을 주고받거나 사고팖.
거론	ㄱㅓㄹㅗㄴ	어떤 것을 이야기의 주제나 문제로 삼아 논의함.
거름	ㄱㅓㄹㅡㅁ	식물이 잘 자라도록 땅에 뿌리거나 섞는 물질.
거만	ㄱㅓㅁㅏㄴ	잘난 체하며 자기보다 남을 낮추어 봄.
거명	ㄱㅓㅁㅕㅇ	이름을 입에 올려 말함.
거목	ㄱㅓㅁㅗㄱ	매우 굵고 큰 나무.
거물	ㄱㅓㅁㅜㄹ	어떤 분야에서 큰 영향력을 지닌 사람.
거봉	ㄱㅓㅂㅗㅇ	매우 크고 높은 봉우리.
거북	ㄱㅓㅂㅜㄱ	몸은 납작한 타원형이고 목이 짧으며, 단단한 등껍질이 있어 머리와 꼬리, 네 발을 그 안에 움츠려 넣을 수 있는 동물.
거상	ㄱㅓㅅㅏㅇ	큰 규모의 장사를 하거나 돈이 많은 상인.
거성	ㄱㅓㅅㅓㅇ	다른 별에 비해 매우 밝고 큰 별.
거세	ㄱㅓㅅㅓㅣ	남자나 수컷의 생식 기능을 제거함.
거실	ㄱㅓㅅㅣㄹ	서양식 집에서, 가족이 모여서 생활하거나 손님을 맞는 중심 공간.
거역	ㄱㅓㅇㅕㄱ	윗사람의 뜻이나 명령 등을 따르지 않고 거스름.
거울	ㄱㅓㅇㅜㄹ	물체의 모양을 비추어 보는 얇고 평평한 물건.
거웃	ㄱㅓㅇㅜㅅ	사람의 성기 주위에 난 털.
거위	ㄱㅓㅇㅜㅣ	털은 하얗고 부리는 노란색이며 목이 긴, 오리처럼 생긴 새.
거의	ㄱㅓㅇㅡㅣ	전부에서 조금 모자란 정도.
거인	ㄱㅓㅇㅣㄴ	보통 사람보다 몸과 키가 훨씬 큰 사람.
거장	ㄱㅓㅈㅏㅇ	특정 분야에서 능력이나 실력이 뛰어난 사람.
거적	ㄱㅓㅈㅓㄱ	바닥에 깔거나 위에 덮기 위해 짚으로 넓적하게 짠 물건.
거절	ㄱㅓㅈㅓㄹ	다른 사람의 부탁이나 제안, 선물 등을 받아들이지 않음.
거점	ㄱㅓㅈㅓㅁ	어떤 활동을 하는 데에 중심이 되는 중요한 지점.
거죽	ㄱㅓㅈㅜㄱ	사물이나 생물의 겉 부분.
거짓	ㄱㅓㅈㅣㅅ	사실이 아닌 것을 사실처럼 꾸민 것.
거취	ㄱㅓㅊㅜㅣ	어떤 사람이 간 곳이나 가야 할 방향.
거품	ㄱㅓㅍㅜㅁ	액체 속에 공기가 들어가 만들어진 속이 빈 둥근 방울.
건기	ㄱㅓㄴㄱㅣ	비가 별로 내리지 않아 메마른 시기.
건너	ㄱㅓㄴㄴㅓ	어떤 곳 너머의 맞은편.
건사	ㄱㅓㄴㅅㅏ	사람을 잘 보살피고 돌봄.
건수	ㄱㅓㄴㅅㅜ	특정한 사건이 일어난 횟수.
건아	ㄱㅓㄴㅇㅏ	씩씩하고 강한 젊은 남자.
건조	ㄱㅓㄴㅈㅗ	건축물이나 배 등을 설계하여 만듦.
건초	ㄱㅓㄴㅊㅗ	주로 짐승의 먹이나 거름으로 쓰는, 베어서 말린 풀.
건투	ㄱㅓㄴㅌㅜ	의지를 굽히지 않고 씩씩하게 잘 싸움.
걷기	ㄱㅓㄷㄱㅣ	걷는 것.
검거	ㄱㅓㅁㄱㅓ	수사 기관이 법을 어기거나 범죄를 저지른 사람을 잡아서 가두는 일.
검도	ㄱㅓㅁㄷㅗ	두 사람이 대나무로 만든 칼로 상대를 치거나 찔러 승패를 겨루는 경기.
검무	ㄱㅓㅁㅁㅜ	칼을 들고 휘두르면서 추는 춤.
검사	ㄱㅓㅁㅅㅏ	범죄를 수사하고 범인을 고발하는 사법 공무원.
검소	ㄱㅓㅁㅅㅗ	사치스럽거나 화려하지 않고 평범함.
검시	ㄱㅓㅁㅅㅣ	사망 원인이 범죄로 인한 것인지를 알기 위해 시체를 검사함.
검지	ㄱㅓㅁㅈㅣ	엄지손가락과 가운뎃손가락 사이에 있는 손가락. 둘째 손가락.
검토	ㄱㅓㅁㅌㅗ	내용을 자세히 따져 봄.
검표	ㄱㅓㅁㅍㅛ	담당 직원이 차표, 배표, 비행기 표 등을 검사함.
겁보	ㄱㅓㅂㅂㅗ	어떤 일에 쉽게 무서워하는 마음을 갖는 사람.
게시	ㄱㅓㅣㅅㅣ	여러 사람이 알 수 있도록 내걸어 두루 보게 함.
겨냥	ㄱㅕㄴㅑㅇ	어떤 사물을 활이나 총 등으로 맞추려고 겨눔.
겨레	ㄱㅕㄹㅓㅣ	같은 조상을 섬기며 역사를 함께하는 민족.
겨룸	ㄱㅕㄹㅜㅁ	누가 더 힘이 센지, 누가 더 뛰어난지 드러나도록 싸움.
겨울	ㄱㅕㅇㅜㄹ	네 계절 중의 하나로 가을과 봄 사이의 추운 계절.
격노	ㄱㅕㄱㄴㅗ	몹시 화를 냄.
격려	ㄱㅕㄱㄹㅕ	용기나 의욕이 생기도록 기운을 북돋아 줌.
격리	ㄱㅕㄱㄹㅣ	다른 것과 서로 통하지 못하게 사이를 막거나 떼어 놓음.
격무	ㄱㅕㄱㅁㅜ	몹시 바쁘고 힘든 일.
격자	ㄱㅕㄱㅈㅏ	가로와 세로를 일정한 간격으로 직각이 되도록 짠 구조나 물건. 또는 그런 형식.
격조	ㄱㅕㄱㅈㅗ	예술 작품에서 내용과 구성의 조화로 이루어지는 예술적 분위기 또는 멋.
격주	ㄱㅕㄱㅈㅜ	한 주일을 빼고 넘어감. 또는 중간에 한 주일씩 계속 빼고 넘어감.
격차	ㄱㅕㄱㅊㅏ	수준이나 품질, 수량 등이 서로 벌어진 차이.
격추	ㄱㅕㄱㅊㅜ	날아가는 비행 물체를 공격하여 떨어뜨림.
격투	ㄱㅕㄱㅌㅜ	서로 맨몸으로 맞붙어 치고받으며 심하게 싸움.
격파	ㄱㅕㄱㅍㅏ	단단한 물체를 맨손이나 발, 머리로 쳐서 깨뜨림.
격하	ㄱㅕㄱㅎㅏ	자격이나 등급, 지위 등이 낮아짐. 또는 그렇게 함.
견사	ㄱㅕㄴㅅㅏ	비단을 짜는 데 쓰는, 누에고치에서 뽑은 실.
견우	ㄱㅕㄴㅇㅜ	견우와 직녀 이야기에 나오는 남자 목동. 은하수를 사이에 두고 직녀와 헤어져 있다가 일 년에 단 한 번, 음력 7월 7일에 까치와 까마귀가 놓아 준 다리인 오작교에서 직녀와 만날 수 있다고 한다.
견지	ㄱㅕㄴㅈㅣ	무엇을 바라보거나 판단하는 입장.
결구	ㄱㅕㄹㄱㅜ	편지나 시를 끝맺는 마지막 부분.
결사	ㄱㅕㄹㅅㅏ	죽음을 각오하고 있는 힘을 다함.
결여	ㄱㅕㄹㅇㅕ	있어야 할 것이 없거나 모자람.
결투	ㄱㅕㄹㅌㅜ	이기고 지는 것을 결정하기 위해 벌이는 싸움.
겸비	ㄱㅕㅁㅂㅣ	두 가지 이상을 함께 갖춤.
겸사	ㄱㅕㅁㅅㅏ	한 가지 일을 하는 김에 다른 일도 함께 함.
겸허	ㄱㅕㅁㅎㅓ	잘난 체 하지 않고 스스로 자신을 낮춤.
경고	ㄱㅕㅇㄱㅗ	위험한 일을 조심하거나 삼가도록 미리 일러서 주의를 줌. 또는 그 주의.
경구	ㄱㅕㅇㄱㅜ	인생의 진리나 가르침을 담은 짧은 문장.
경기	ㄱㅕㅇㄱㅣ	매매나 거래에 나타나는 호황, 불황과 같이 경제 분야에 관련되어 나타나는 상황.
경도	ㄱㅕㅇㄷㅗ	지구 위의 위치를 세로로 나타내는 것.
경로	ㄱㅕㅇㄹㅗ	노인을 공손히 받들어 모심.
경리	ㄱㅕㅇㄹㅣ	어떤 기관이나 단체에서 돈이나 물건을 내주고 받는 일. 또는 그런 일을 맡은 부서나 사람.
경마	ㄱㅕㅇㅁㅏ	말을 타고 일정한 거리를 달려 빠르기를 겨루는 경기.
경보	ㄱㅕㅇㅂㅗ	위험에 대비하여 주의하고 조심할 수 있도록 미리 알리는 일, 또는 그 보도나 신호.
경비	ㄱㅕㅇㅂㅣ	어떤 일을 하는 데 필요한 비용.
경사	ㄱㅕㅇㅅㅏ	바닥이 평평하지 않고 기울어진 부분, 또는 그런 상태나 정도.
경서	ㄱㅕㅇㅅㅓ	유교의 가르침을 써 놓은 책.
경시	ㄱㅕㅇㅅㅣ	어떤 대상을 중요하게 보지 않고 하찮게 여김.
경어	ㄱㅕㅇㅇㅓ	상대를 높이는 말.
경우	ㄱㅕㅇㅇㅜ	당연히 행하여야 할 바른 이치.
경유	ㄱㅕㅇㅇㅠ	목적지에 가는 도중 어떤 곳을 들르거나 지나감.
경이	ㄱㅕㅇㅇㅣ	놀랍고 신기하게 여김. 또는 그럴 만한 일.
경조	ㄱㅕㅇㅈㅗ	죽은 이를 존경하는 마음으로 슬픔을 표함.
경주	ㄱㅕㅇㅈㅜ	경상북도의 동남부에 있는 시. 오랫동안 신라의 수도였고 많은 문화유산이 있어 유명한 관광 도시이다.
경지	ㄱㅕㅇㅈㅣ	학문이나 예술 등에서 일정한 특성과 체계를 갖춘 독자적인 범주나 부분.
경차	ㄱㅕㅇㅊㅏ	무게가 가볍고 크기가 작은 승용차.
경추	ㄱㅕㅇㅊㅜ	목에 있는 일곱 개의 뼈.
경치	ㄱㅕㅇㅊㅣ	자연이나 지역의 아름다운 모습.
경호	ㄱㅕㅇㅎㅗ	위험한 일에 대비하여 중요한 사람이나, 물건, 시설 등을 보호함.
계교	ㄱㅕㅣㄱㅛ	생각을 많이 하여 짜낸 꾀.
계기	ㄱㅕㅣㄱㅣ	어떤 일이 일어나거나 결정되도록 하는 원인이나 기회.
계도	ㄱㅕㅣㄷㅗ	사람들을 가르치고 지도함.
계모	ㄱㅕㅣㅁㅗ	아버지가 새로 결혼해서 생긴 어머니.
계보	ㄱㅕㅣㅂㅗ	조상 때부터 내려오는 한 집안의 혈통과 역사를 적은 책.
계부	ㄱㅕㅣㅂㅜ	어머니가 새로 결혼해서 생긴 아버지.
계수	ㄱㅕㅣㅅㅜ	문자와 숫자로 된 수학식에서 기호 문자 앞에 붙는 숫자.
계시	ㄱㅕㅣㅅㅣ	신적인 존재나 초자연적인 현상을 통하여 사람이 알아낼 수 없는 진리를 알게 함. 또는 그런 진리.
계주	ㄱㅕㅣㅈㅜ	일정한 거리를 나누어 몇 사람이 차례대로 이어 달리는 경기.
계파	ㄱㅕㅣㅍㅏ	정치에서 같은 이해 관계를 가진 사람들의 조직.
계피	ㄱㅕㅣㅍㅣ	향료나 한약재로 쓰며, 매운 향이 나고 붉은 갈색인 계수나무의 속껍질.
고갈	ㄱㅗㄱㅏㄹ	물이 말라서 없어짐.
고개	ㄱㅗㄱㅏㅣ	목을 포함한 머리 부분.
고견	ㄱㅗㄱㅕㄴ	뛰어난 의견이나 생각.
고공	ㄱㅗㄱㅗㅇ	높은 공중.
고국	ㄱㅗㄱㅜㄱ	남의 나라에 가 있는 사람이 말하는 '자기 나라'.
고궁	ㄱㅗㄱㅜㅇ	옛날에 임금이 살던 집.
고귀	ㄱㅗㄱㅜㅣ	훌륭하고 귀중함.
고금	ㄱㅗㄱㅡㅁ	옛날과 지금.
고급	ㄱㅗㄱㅡㅂ	물건이나 시설 등의 품질이 뛰어남.
고난	ㄱㅗㄴㅏㄴ	매우 괴롭고 어려움.
고뇌	ㄱㅗㄴㅗㅣ	괴로워하며 생각을 하고 고민함.
고담	ㄱㅗㄷㅏㅁ	고것에 뒤이어 오는 때나 자리.
고대	ㄱㅗㄷㅏㅣ	원시 시대와 중세 사이의 아주 옛 시대.
고독	ㄱㅗㄷㅗㄱ	세상에 혼자 있는 듯이 외롭고 쓸쓸함.
고동	ㄱㅗㄷㅗㅇ	증기 기관으로 움직이는 배에서 신호로 내보내는 큰 소리.
고둥	ㄱㅗㄷㅜㅇ	나사와 같이 둥글게 말려있는 모양의 단단한 껍데기를 가지며 물속에서 사는 동물.
고등	ㄱㅗㄷㅡㅇ	상대적으로 높은 등급이나 수준.
고딕	ㄱㅗㄷㅣㄱ	획이 일정하게 굵고 반듯한 글자 꼴.
고락	ㄱㅗㄹㅏㄱ	괴로움과 즐거움.
고랑	ㄱㅗㄹㅏㅇ	밭에 작물을 심기 위해 흙을 쌓아 올려 길게 만든 언덕과 언덕 사이로 움푹하게 파인 곳.
고래	ㄱㅗㄹㅏㅣ	몸집이 매우 크며 물고기처럼 생긴, 바다에 사는 동물.
고령	ㄱㅗㄹㅕㅇ	나이가 많음. 또는 많은 나이.
고름	ㄱㅗㄹㅡㅁ	상처에 염증이 생겼을 때 피부에서 나오는 걸쭉하고 불투명한 액체.
고립	ㄱㅗㄹㅣㅂ	다른 곳이나 사람과 교류하지 못하고 혼자 따로 떨어짐.
고막	ㄱㅗㅁㅏㄱ	소리를 들을 수 있게 하는 귀 안쪽의 얇은 막.
고명	ㄱㅗㅁㅕㅇ	음식의 맛이나 모양을 더 좋게 하려고 손질하여 음식 위에 뿌리거나 얹는 재료.
고목	ㄱㅗㅁㅗㄱ	오래된 큰 나무.
고문	ㄱㅗㅁㅜㄴ	옛 글.
고물	ㄱㅗㅁㅜㄹ	맛과 모양을 더하기 위하여 떡의 겉에 묻히는 가루.
고민	ㄱㅗㅁㅣㄴ	마음속에 걱정거리가 있어 괴로워하고 계속 신경 씀.
고발	ㄱㅗㅂㅏㄹ	감춰져 있던 잘못이나 비리 등을 공개적으로 많은 사람에게 알림.
고배	ㄱㅗㅂㅏㅣ	(비유적으로) 주로 실패로 인한 쓰라린 경험.
고별	ㄱㅗㅂㅕㄹ	같이 있던 사람들에게 헤어짐을 알림.
고봉	ㄱㅗㅂㅗㅇ	밥이나 곡식 등을 그릇에 수북하게 담는 것.
고분	ㄱㅗㅂㅜㄴ	아주 먼 옛날에 만들어진 무덤.
고삐	ㄱㅗㅂㅂㅣ	소나 말을 몰거나 부릴 때 소의 코뚜레나 말의 재갈에 매어 손에 잡고 끄는 줄.
고산	ㄱㅗㅅㅏㄴ	높은 산.
고새	ㄱㅗㅅㅏㅣ	조금 멀어진 어느 때부터 다른 어느 때까지의 매우 짧은 동안.
고성	ㄱㅗㅅㅓㅇ	오래전에 지어진 성.
고속	ㄱㅗㅅㅗㄱ	매우 빠른 속도.
고승	ㄱㅗㅅㅡㅇ	덕이 높거나 지위가 높은 중.
고심	ㄱㅗㅅㅣㅁ	해결하기 어려운 일에 대해 마음을 써 생각함.
고안	ㄱㅗㅇㅏㄴ	연구를 하여 새로운 물건이나 방법, 계획 등을 생각해 냄.
고압	ㄱㅗㅇㅏㅂ	바람이나 물 등의 압력이 보통보다 높은 압력.
고약	ㄱㅗㅇㅑㄱ	헐거나 곪은 상처 부위에 붙이는 끈적끈적한 한약.
고양	ㄱㅗㅇㅑㅇ	정신이나 의식 등을 높임.
고역	ㄱㅗㅇㅕㄱ	몹시 힘들고 괴로운 일.
고열	ㄱㅗㅇㅕㄹ	높은 열.
고온	ㄱㅗㅇㅗㄴ	높은 온도.
고용	ㄱㅗㅇㅛㅇ	돈을 주고 사람에게 일을 시킴.
고위	ㄱㅗㅇㅜㅣ	높은 지위.
고을	ㄱㅗㅇㅡㄹ	(옛날에) 국가 기관이 있던 지방의 중심지.
고음	ㄱㅗㅇㅡㅁ	높은 소리.
고의	ㄱㅗㅇㅡㅣ	일부러 하는 생각이나 태도.
고인	ㄱㅗㅇㅣㄴ	옛날 사람.
고작	ㄱㅗㅈㅏㄱ	아무리 높거나 많게 잡아도 별것 아닌 것의 전부.
고장	ㄱㅗㅈㅏㅇ	사람들이 사는 일정한 지역.
고적	ㄱㅗㅈㅓㄱ	옛 건물이나 시설이 남아 있어 옛 문화를 보여 주는 곳.
고전	ㄱㅗㅈㅓㄴ	오래전부터 내려오던 방식이나 형식.
고정	ㄱㅗㅈㅓㅇ	한번 정한 내용을 변경하지 않음.
고종	ㄱㅗㅈㅗㅇ	고모의 아들이나 딸과의 친족 관계. 또는 그런 관계에 있는 사람.
고증	ㄱㅗㅈㅡㅇ	옛날 책이나 유물을 통해 예전에 있던 사물들의 시대, 가치, 내용 등을 증명함.
고질	ㄱㅗㅈㅣㄹ	오래되어 고치기 힘든 병.
고집	ㄱㅗㅈㅣㅂ	자기의 생각이나 주장을 굽히지 않고 버팀.
고착	ㄱㅗㅊㅏㄱ	일정한 상태로 굳어져 변하지 않음.
고찰	ㄱㅗㅊㅏㄹ	어떤 것을 깊이 생각하고 면밀히 연구함.
고참	ㄱㅗㅊㅏㅁ	한 조직에 오래전부터 있었던 사람.
고철	ㄱㅗㅊㅓㄹ	오래되거나 쓰고 버린 쇠붙이.
고체	ㄱㅗㅊㅓㅣ	일정한 굳은 모양과 부피를 가지고 있어서 만지고 볼 수 있는 물질.
고충	ㄱㅗㅊㅜㅇ	괴로운 마음이나 어려운 사정.
고취	ㄱㅗㅊㅜㅣ	생각이나 마음, 의욕 등이 강해지도록 함.
고층	ㄱㅗㅊㅡㅇ	여러 층으로 된 것의 위쪽에 있는 층.
고통	ㄱㅗㅌㅗㅇ	몸이나 마음이 괴롭고 아픔.
고풍	ㄱㅗㅍㅜㅇ	옛날의 풍속.
고학	ㄱㅗㅎㅏㄱ	스스로 학비를 벌어서 고생하며 학교를 다님.
고함	ㄱㅗㅎㅏㅁ	크게 외치는 목소리.
고해	ㄱㅗㅎㅏㅣ	가톨릭에서, 신자가 자신의 죄를 뉘우치고 신부를 통해 하느님에게 고백하여 용서받음. 또는 그런 일.
고향	ㄱㅗㅎㅑㅇ	태어나서 자란 곳.
고혈	ㄱㅗㅎㅕㄹ	(비유적으로) 매우 고생하여 어렵게 모은 적은 재물.
고형	ㄱㅗㅎㅕㅇ	어떤 물질이 일정한 모양으로 단단하게 굳어 있는 것.
고희	ㄱㅗㅎㅡㅣ	일흔 살의 나이.
곡기	ㄱㅗㄱㄱㅣ	곡식으로 만든 음식.
곡류	ㄱㅗㄱㄹㅠ	물이 구부러져 흘러감. 또는 그 흐름.
곡우	ㄱㅗㄱㅇㅜ	모를 심을 때 필요한 비가 내린다는 날로 이십사절기의 하나. 4월 20일경이다. 이 무렵에 비가 오면 곡식이 잘 자라 풍년이 든다고 한다.
곡조	ㄱㅗㄱㅈㅗ	음악이나 노래의 흐름.
곡주	ㄱㅗㄱㅈㅜ	곡식으로 만든 술.
곤지	ㄱㅗㄴㅈㅣ	전통 혼례에서 신부의 이마 가운데에 그리는 붉은 점.
골무	ㄱㅗㄹㅁㅜ	바느질할 때 바늘을 밀기 위해 손가락에 끼는 도구.
골수	ㄱㅗㄹㅅㅜ	뼈의 중심부에 가득 차 있는 연한 물질.
골자	ㄱㅗㄹㅈㅏ	어떤 말이나 일에서 가장 중심이 되는 내용.
골조	ㄱㅗㄹㅈㅗ	철근과 콘크리트로 만든 건물의 뼈대.
골초	ㄱㅗㄹㅊㅗ	(놀리는 말로) 담배를 너무 많이 피우는 사람.
골치	ㄱㅗㄹㅊㅣ	(속된 말로) 머리.
골퍼	ㄱㅗㄹㅍㅓ	취미 또는 직업으로 골프를 하는 사람.
골프	ㄱㅗㄹㅍㅡ	넓은 풀밭에서 여러 개의 구멍을 파 놓고 공을 긴 채로 쳐서 구멍에 집어넣는 경기.
곰보	ㄱㅗㅁㅂㅗ	천연두로 인해 생긴 얼굴의 상처 자국.
곱자	ㄱㅗㅂㅈㅏ	‘ㄱ’자 모양의 자.
공고	ㄱㅗㅇㄱㅗ	‘공업 고등학교’를 줄여 이르는 말.
공구	ㄱㅗㅇㄱㅜ	톱, 망치, 송곳 등 물건을 만들거나 고치는 데에 쓰는 기구나 도구.
공기	ㄱㅗㅇㄱㅣ	작은 돌 다섯 개를 일정한 규칙에 따라 집고 받는 아이들의 놀이. 또는 그 돌.
공로	ㄱㅗㅇㄹㅗ	어떤 일을 위해 바친 노력과 수고. 또는 그 결과.
공리	ㄱㅗㅇㄹㅣ	공공의 이익.
공모	ㄱㅗㅇㅁㅗ	일반에게 널리 공개하여 모집함.
공무	ㄱㅗㅇㅁㅜ	여러 사람에 관련된 공적인 일.
공보	ㄱㅗㅇㅂㅗ	국가 기관이 각종 업무 및 활동 상황을 국민에게 널리 알림.
공부	ㄱㅗㅇㅂㅜ	학문이나 기술을 배워서 지식을 얻음.
공비	ㄱㅗㅇㅂㅣ	관청이나 공공 단체에서 공적인 목적으로 쓰는 돈.
공사	ㄱㅗㅇㅅㅏ	시설이나 건물 등을 새로 짓거나 고침.
공소	ㄱㅗㅇㅅㅗ	검사가 법원에 형사 사건의 재판을 청구함.
공수	ㄱㅗㅇㅅㅜ	공격과 수비.
공시	ㄱㅗㅇㅅㅣ	공공 기관이 어떤 내용을 공개하여 일반에 널리 알림.
공여	ㄱㅗㅇㅇㅕ	어떤 물건이나 이익 등을 상대편에게 돌아가도록 함.
공유	ㄱㅗㅇㅇㅠ	국가나 공공 단체의 소유.
공자	ㄱㅗㅇㅈㅏ	유교를 처음으로 만든 중국의 사상가이자 학자(기원전 551~기원전479). 노나라 사람으로 윤리와 도덕을 중요시했다.
공저	ㄱㅗㅇㅈㅓ	책이나 글을 여러 사람이 함께 지음. 또는 그렇게 지은 책.
공조	ㄱㅗㅇㅈㅗ	여러 사람이나 집단이 서로 돕는 것.
공주	ㄱㅗㅇㅈㅜ	왕과 왕비 사이에 태어난 딸.
공지	ㄱㅗㅇㅈㅣ	많은 사람들에게 어떤 내용을 널리 알림.
공터	ㄱㅗㅇㅌㅓ	집이나 밭 등이 없는 빈 땅.
공포	ㄱㅗㅇㅍㅗ	확정된 법이나 규정 등을 일반 대중에게 널리 알림.
공표	ㄱㅗㅇㅍㅛ	여러 사람에게 널리 알림.
공허	ㄱㅗㅇㅎㅓ	아무것도 없이 텅 빔.
과거	ㄱㅗㅏㄱㅓ	고려와 조선 시대에 실시했던 관리를 뽑기 위한 국가 시험.
과다	ㄱㅗㅏㄷㅏ	수나 양이 지나치게 많거나 어떤 일을 많이 함.
과도	ㄱㅗㅏㄷㅗ	과일을 깎거나 자르는 데 사용하는 칼.
과로	ㄱㅗㅏㄹㅗ	몸이 힘들 정도로 지나치게 일을 하는 것. 또는 그로 인한 심한 피로.
과료	ㄱㅗㅏㄹㅛ	가벼운 범죄에 물리는 적은 액수의 벌금.
과부	ㄱㅗㅏㅂㅜ	남편이 죽고 나서 남편 없이 사는 여자.
과소	ㄱㅗㅏㅅㅗ	크기 등이 지나치게 작음.
과수	ㄱㅗㅏㅅㅜ	사과나 배 등과 같은 과일이 나는 나무.
과시	ㄱㅗㅏㅅㅣ	자신의 능력이나 솜씨 등을 자랑스럽게 드러냄.
과오	ㄱㅗㅏㅇㅗ	잘못이나 실수.
과자	ㄱㅗㅏㅈㅏ	밀가루나 쌀가루 등에 우유, 설탕 등을 넣고 반죽하여 굽거나 튀긴 간식.
괴기	ㄱㅗㅣㄱㅣ	괴상하고 기이함.
괴리	ㄱㅗㅣㄹㅣ	사실들이 서로 어긋나 생겨난 차이.
괴수	ㄱㅗㅣㅅㅜ	공상의 동물로 무섭고 매우 이상한 짐승.
교각	ㄱㅛㄱㅏㄱ	다리를 받치는 기둥.
교감	ㄱㅛㄱㅏㅁ	말로 하지 않아도 서로의 감정이나 생각을 느낌.
교과	ㄱㅛㄱㅗㅏ	학교에서 학생이 배워야 할 내용을 체계적으로 나누어 놓은 것.
교내	ㄱㅛㄴㅏㅣ	학교 안.
교단	ㄱㅛㄷㅏㄴ	교실에서 교사가 가르칠 때 올라서는 주변보다 조금 높은 자리.
교대	ㄱㅛㄷㅏㅣ	어떤 일을 여러 사람이 나누어서 차례를 바꾸어 가며 함.
교란	ㄱㅛㄹㅏㄴ	어떤 체계의 질서나 사람의 마음을 뒤흔들어 어지럽게 함.
교량	ㄱㅛㄹㅑㅇ	강이나 바다를 사람이나 차가 건널 수 있게 만든 다리.
교련	ㄱㅛㄹㅕㄴ	가르쳐서 몸과 마음을 굳세게 함.
교만	ㄱㅛㅁㅏㄴ	잘난 체하면서 남을 무시하고 말이나 행동이 건방짐.
교목	ㄱㅛㅁㅗㄱ	기독교 학교에서 예배와 종교 교육을 맡은 목사.
교문	ㄱㅛㅁㅜㄴ	학교의 문.
교민	ㄱㅛㅁㅣㄴ	국외에서 살고 있는 국민.
교배	ㄱㅛㅂㅏㅣ	다음 세대를 얻기 위하여 생물의 암수를 인공적으로 수정시킴.
교범	ㄱㅛㅂㅓㅁ	가르치는 데 본보기가 되는 방법. 또는 그것에 관한 책.
교복	ㄱㅛㅂㅗㄱ	각 학교에서 학생들이 입도록 특별히 정한 옷.
교본	ㄱㅛㅂㅗㄴ	교재로 쓰는 책.
교분	ㄱㅛㅂㅜㄴ	서로 가깝게 지내며 나눈 정.
교살	ㄱㅛㅅㅏㄹ	목을 졸라 죽임.
교섭	ㄱㅛㅅㅓㅂ	어떤 일에 대하여 서로 의견이 다른 사람 또는 집단이 그 일을 이루기 위하여 서로 의논하여 의견을 조정함.
교성	ㄱㅛㅅㅓㅇ	여자가 애교를 부릴 때 내는 가늘고 예쁜 목소리.
교세	ㄱㅛㅅㅓㅣ	종교의 상황이나 세력.
교습	ㄱㅛㅅㅡㅂ	지식이나 기술 등을 가르쳐 익히게 함.
교신	ㄱㅛㅅㅣㄴ	우편이나 전화 등을 이용해 정보나 의견을 주고받음.
교실	ㄱㅛㅅㅣㄹ	유치원, 초등학교, 중학교, 고등학교에서 교사가 학생들을 가르치는 방.
교안	ㄱㅛㅇㅏㄴ	수업에서 가르칠 내용을 적은 계획서.
교양	ㄱㅛㅇㅑㅇ	사회적 경험이나 학식을 바탕으로 사회생활, 문화 등 여러 분야에 걸쳐 쌓은 지식이나 품위.
교언	ㄱㅛㅇㅓㄴ	교묘하게 꾸며 낸 말.
교역	ㄱㅛㅇㅕㄱ	나라와 나라 사이에 물건을 서로 사고팖.
교열	ㄱㅛㅇㅕㄹ	문서의 내용 중에 잘못된 것을 바로잡음.
교외	ㄱㅛㅇㅗㅣ	도시 주변의 한가롭고 조용한 지역.
교육	ㄱㅛㅇㅠㄱ	개인의 능력을 키우기 위해 지식, 교양, 기술 등을 가르치는 일.
교인	ㄱㅛㅇㅣㄴ	종교가 있는 사람.
교장	ㄱㅛㅈㅏㅇ	초, 중, 고등학교에서 각 학교의 교육과 행정을 책임지고 학교를 대표하는 직위. 또는 그 직위에 있는 사람.
교재	ㄱㅛㅈㅏㅣ	교육이나 학습을 하는 데 필요한 교과서나 그 외의 자료.
교전	ㄱㅛㅈㅓㄴ	군대가 맞붙어 싸움.
교접	ㄱㅛㅈㅓㅂ	정신적 또는 육체적으로 서로 닿아 접촉함.
교정	ㄱㅛㅈㅓㅇ	원고와 인쇄물을 대조하여 글자가 잘못되거나 틀리게 인쇄된 것, 배열이나 색이 잘못된 것 등을 바르게 고침.
교제	ㄱㅛㅈㅓㅣ	서로 사귀며 가깝게 지냄.
교직	ㄱㅛㅈㅣㄱ	학생을 가르치는 직업.
교착	ㄱㅛㅊㅏㄱ	어떤 상태가 굳어져 달라지거나 나아지지 않고 그대로 있음.
교체	ㄱㅛㅊㅓㅣ	특정한 역할을 하던 사람이나 사물, 제도 등을 다른 사람, 사물, 제도 등으로 바꿈.
교칙	ㄱㅛㅊㅣㄱ	학생이 학교에서 지켜야 할 규칙.
교탁	ㄱㅛㅌㅏㄱ	학교에서, 교사가 수업을 할 때에 책 등을 올려놓기 위하여 교단 위나 앞에 놓은 탁자.
교태	ㄱㅛㅌㅏㅣ	여자가 아양을 부리는 표정과 몸짓.
교통	ㄱㅛㅌㅗㅇ	자동차, 기차, 배, 비행기 등의 탈것을 이용하여 사람이나 짐이 오고 가는 일.
교편	ㄱㅛㅍㅕㄴ	교사가 수업에서 필요한 사항을 가리키기 위하여 사용하는 막대기.
교합	ㄱㅛㅎㅏㅂ	성적으로 관계를 맺음.
교화	ㄱㅛㅎㅗㅏ	가르쳐서 좋은 방향으로 나아가게 함.
교회	ㄱㅛㅎㅗㅣ	예수 그리스도를 구세주로 믿고 따르는 사람들의 공동체. 또는 그런 사람들이 모여 종교 활동을 하는 장소.
교훈	ㄱㅛㅎㅜㄴ	학교의 교육 이념이나 목표를 나타내는 짧은 말.
구간	ㄱㅜㄱㅏㄴ	어떤 지점과 다른 지점과의 사이.
구강	ㄱㅜㄱㅏㅇ	입에서 목구멍까지의 공간.
구걸	ㄱㅜㄱㅓㄹ	남에게 돈이나 먹을 것, 물건 등을 대가 없이 달라고 함.
구경	ㄱㅜㄱㅕㅇ	흥미나 관심을 가지고 봄.
구국	ㄱㅜㄱㅜㄱ	나라를 위기에서 구하는 것.
구근	ㄱㅜㄱㅡㄴ	땅속에 있는 잎이나 뿌리, 줄기 등이 달걀 모양으로 크고 뚱뚱하게 양분을 저장한 것.
구금	ㄱㅜㄱㅡㅁ	유죄를 선고받았거나 죄가 있다고 의심되는 사람을 교도소나 구치소에 가두는 것.
구급	ㄱㅜㄱㅡㅂ	위급한 상황에서 구하여 냄.
구김	ㄱㅜㄱㅣㅁ	구겨져서 생긴 주름.
구내	ㄱㅜㄴㅏㅣ	회사, 병원, 역과 같이 큰 건물이나 시설의 안.
구단	ㄱㅜㄷㅏㄴ	야구나 축구와 같이 공으로 하는 운동 경기를 사업으로 하는 단체.
구독	ㄱㅜㄷㅗㄱ	책이나 잡지, 신문 등을 구입하여 읽음.
구들	ㄱㅜㄷㅡㄹ	불을 때면 방바닥 전체가 따뜻해지는 한국 전통의 난방 장치.
구렁	ㄱㅜㄹㅓㅇ	움푹하게 파인 땅.
구령	ㄱㅜㄹㅕㅇ	어떤 일정한 동작을 여러 사람이 맞추어 하기 위해 소리쳐 알리는 간단한 명령.
구름	ㄱㅜㄹㅡㅁ	공기 속의 작은 물방울이나 얼음 알갱이가 한데 뭉쳐 하늘에 떠 있는 것.
구매	ㄱㅜㅁㅏㅣ	상품을 삼.
구멍	ㄱㅜㅁㅓㅇ	뚫어지거나 파낸 자리.
구면	ㄱㅜㅁㅕㄴ	둥근 물체의 겉면.
구명	ㄱㅜㅁㅕㅇ	사물의 본질이나 원인 등을 깊이 연구하여 밝힘.
구문	ㄱㅜㅁㅜㄴ	문장의 구성.
구민	ㄱㅜㅁㅣㄴ	그 구 안에 사는 사람.
구박	ㄱㅜㅂㅏㄱ	못 견딜 정도로 매우 심하게 괴롭힘.
구법	ㄱㅜㅂㅓㅂ	예전의 법.
구변	ㄱㅜㅂㅕㄴ	말을 잘하는 재주.
구별	ㄱㅜㅂㅕㄹ	성질이나 종류에 따라 차이가 남. 또는 성질이나 종류에 따라 갈라놓음.
구분	ㄱㅜㅂㅜㄴ	어떤 기준에 따라 전체를 몇 개의 부분으로 나눔.
구상	ㄱㅜㅅㅏㅇ	일정한 형태와 성질을 갖춘 구체적인 것.
구석	ㄱㅜㅅㅓㄱ	모퉁이의 안쪽.
구설	ㄱㅜㅅㅓㄹ	남을 비난하거나 그 사람의 권위를 떨어뜨리는 말.
구성	ㄱㅜㅅㅓㅇ	여러 필요한 사람이나 몇 가지의 부분 혹은 요소를 모아서 하나로 만드는 일, 또는 그렇게 해서 이루어진 것.
구속	ㄱㅜㅅㅗㄱ	생각이나 행동의 자유를 제한하거나 속박함.
구술	ㄱㅜㅅㅜㄹ	입으로 말함.
구슬	ㄱㅜㅅㅡㄹ	보석이나 유리 등으로 둥글게 만든 물건.
구습	ㄱㅜㅅㅡㅂ	예전부터 내려오는 시대에 뒤떨어진 풍습.
구식	ㄱㅜㅅㅣㄱ	예전의 방법이나 형식.
구실	ㄱㅜㅅㅣㄹ	마땅히 해야 할 일이나 역할.
구심	ㄱㅜㅅㅣㅁ	중심으로 가까워지거나 모임.
구애	ㄱㅜㅇㅏㅣ	이성에게 사랑을 구함.
구약	ㄱㅜㅇㅑㄱ	기독교에서, 예수가 나기 전에 하나님이 이스라엘 민족에게 준 구원의 약속.
구역	ㄱㅜㅇㅕㄱ	어떤 기준이나 특성에 따라 여럿으로 나누어 놓은 지역 중 하나.
구연	ㄱㅜㅇㅕㄴ	여러 사람 앞에서 어떤 이야기의 내용을 실감 나고 재미있게 말로 이야기함.
구인	ㄱㅜㅇㅣㄴ	일할 사람을 구함.
구입	ㄱㅜㅇㅣㅂ	물건 등을 삼.
구장	ㄱㅜㅈㅏㅇ	축구나 야구 등의 시합을 하는 큰 운동장.
구전	ㄱㅜㅈㅓㄴ	말로 전하여 내려옴. 또는 말로 전함.
구절	ㄱㅜㅈㅓㄹ	한 토막의 말이나 글.
구정	ㄱㅜㅈㅓㅇ	음력 1월 1일에 쇠는 설.
구제	ㄱㅜㅈㅓㅣ	어려운 처지에 놓인 사람을 도와줌.
구좌	ㄱㅜㅈㅗㅏ	금융 기관에서 각 고객의 저축과 대출 상황 등을 계산하여 기록한 것.
구직	ㄱㅜㅈㅣㄱ	일자리를 구함.
구질	ㄱㅜㅈㅣㄹ	야구, 테니스, 탁구 등에서 선수가 치거나 던진 공의 성질.
구천	ㄱㅜㅊㅓㄴ	사람이 죽은 후에 그 영혼이 가는 곳.
구청	ㄱㅜㅊㅓㅇ	구의 행정 사무를 맡아보는 기관.
구축	ㄱㅜㅊㅜㄱ	시설물을 지음.
구출	ㄱㅜㅊㅜㄹ	위험한 상황에서 구해 냄.
구취	ㄱㅜㅊㅜㅣ	입에서 나는 좋지 않은 냄새.
구태	ㄱㅜㅌㅏㅣ	예전 그대로의 뒤떨어진 상태.
구현	ㄱㅜㅎㅕㄴ	이념이나 사상, 계획 등을 구체적인 모습으로 나타나게 함.
구형	ㄱㅜㅎㅕㅇ	형사 재판에서, 법에 따라 피고인이 받을 형벌의 종류와 양을 검사가 판사에게 요구함.
구혼	ㄱㅜㅎㅗㄴ	결혼할 상대를 구함.
국가	ㄱㅜㄱㄱㅏ	일정한 땅과 거기에 사는 사람들로 구성되고, 주권에 의한 하나의 통치 조직을 이루는 집단.
국고	ㄱㅜㄱㄱㅗ	국가의 돈.
국교	ㄱㅜㄱㄱㅛ	나라와 나라 사이의 외교 관계.
국기	ㄱㅜㄱㄱㅣ	한 나라를 상징하는 깃발.
국도	ㄱㅜㄱㄷㅗ	나라에서 직접 관리하는 주요 도로.
국모	ㄱㅜㄱㅁㅗ	나라의 어머니라는 뜻으로, 임금의 부인.
국무	ㄱㅜㄱㅁㅜ	대통령이나 장관 등이 나라를 다스리고 이끌어 나가기 위해 다루는 국가적인 사무.
국보	ㄱㅜㄱㅂㅗ	국가가 법으로 정해 보호하고 관리하는 문화재.
국부	ㄱㅜㄱㅂㅜ	전체 중 어느 한 부분.
국비	ㄱㅜㄱㅂㅣ	국가 재정으로 부담하는 비용.
국사	ㄱㅜㄱㅅㅏ	한 나라의 역사.
국소	ㄱㅜㄱㅅㅗ	전체 가운데 어느 한 부분.
국수	ㄱㅜㄱㅅㅜ	밀, 메밀, 감자 등의 가루를 반죽하여 칼이나 기계, 손으로 가늘고 길게 만든 식품. 또는 그것을 삶아서 만든 음식.
국시	ㄱㅜㄱㅅㅣ	국가 정책의 기본 방향.
국어	ㄱㅜㄱㅇㅓ	한 나라의 국민들이 사용하는 말.
국유	ㄱㅜㄱㅇㅠ	나라의 소유.
국자	ㄱㅜㄱㅈㅏ	국이나 액체 등을 뜨는 데 쓰는 도구.
국지	ㄱㅜㄱㅈㅣ	한정된 지역.
국치	ㄱㅜㄱㅊㅣ	다른 나라로부터 당한 나라의 수치.
국토	ㄱㅜㄱㅌㅗ	한 나라의 주권이 미치는 땅.
국호	ㄱㅜㄱㅎㅗ	나라의 이름.
군가	ㄱㅜㄴㄱㅏ	군인들의 사기를 높이기 위한 노래.
군기	ㄱㅜㄴㄱㅣ	군대의 규율과 법도.
군무	ㄱㅜㄴㅁㅜ	여러 명이 함께 추는 춤.
군부	ㄱㅜㄴㅂㅜ	군사에 관한 일을 총괄하여 맡아보는 군의 지도부. 또는 그것을 중심으로 한 핵심 세력.
군비	ㄱㅜㄴㅂㅣ	전쟁을 하기 위해 갖춘 군사 시설이나 무기와 같은 장비.
군사	ㄱㅜㄴㅅㅏ	(옛날에) 군인이나 군대.
군소	ㄱㅜㄴㅅㅗ	규모가 작은 여러 개의 것.
군수	ㄱㅜㄴㅅㅜ	군 단위 지역의 행정을 담당하는 제일 높은 직위에 있는 사람, 또는 그 직위.
군자	ㄱㅜㄴㅈㅏ	유교에서 성품이 착하고 슬기로우며, 덕과 학식이 높은 사람.
군주	ㄱㅜㄴㅈㅜ	한 나라를 다스리는 왕.
굴비	ㄱㅜㄹㅂㅣ	소금에 절여서 말린 조기.
굴지	ㄱㅜㄹㅈㅣ	많은 것들 중에서 매우 뛰어남.
굽이	ㄱㅜㅂㅇㅣ	휘어서 구부러진 곳.
궁녀	ㄱㅜㅇㄴㅕ	(옛날에) 궁궐 안에서 왕과 그 가족들을 모시는 시녀.
궁리	ㄱㅜㅇㄹㅣ	어떤 일을 해결할 방법을 깊이 생각함. 또는 그 생각.
궁지	ㄱㅜㅇㅈㅣ	매우 곤란한 처지.
귀가	ㄱㅜㅣㄱㅏ	집으로 돌아가거나 돌아옴.
귀로	ㄱㅜㅣㄹㅗ	돌아오는 길.
귀지	ㄱㅜㅣㅈㅣ	귓구멍 속에 생기는 때.
귀추	ㄱㅜㅣㅊㅜ	일이 진행되는 상황이나 진행된 결과.
귀티	ㄱㅜㅣㅌㅣ	신분이나 지위가 높고 귀하게 보이는 모습이나 태도.
귀하	ㄱㅜㅣㅎㅏ	(높임말로) 편지나 물건을 받을 사람의 이름 뒤에 붙여 쓰는 말.
규격	ㄱㅠㄱㅕㄱ	표준으로 삼아 따르도록 정해 놓은 수치나 형식.
규명	ㄱㅠㅁㅕㅇ	자세히 따져 사실을 밝힘.
규범	ㄱㅠㅂㅓㅁ	한 사회의 구성원으로서 따르고 지켜야 할 원리나 행동 양식.
규약	ㄱㅠㅇㅑㄱ	한 조직체의 구성이나 운영에 관한 규칙.
규율	ㄱㅠㅇㅠㄹ	사회나 조직의 질서를 유지하기 위하여 사람들이 따르도록 정해 놓은 규칙.
규정	ㄱㅠㅈㅓㅇ	규칙으로 정함. 또는 그렇게 정해 놓은 것.
규제	ㄱㅠㅈㅓㅣ	규칙이나 법에 의하여 개인이나 단체의 활동을 제한함.
규칙	ㄱㅠㅊㅣㄱ	여러 사람이 지키도록 정해 놓은 법칙.
규탄	ㄱㅠㅌㅏㄴ	잘못이나 옳지 못한 일에 대하여 따지고 비난함.
규합	ㄱㅠㅎㅏㅂ	목적을 이루기 위해서 힘이나 사람을 한데 모음.
그간	ㄱㅡㄱㅏㄴ	조금 멀어진 어느 때부터 다른 어느 때까지의 비교적 짧은 동안.
그날	ㄱㅡㄴㅏㄹ	앞에서 말한 날.
그네	ㄱㅡㄴㅓㅣ	길게 늘어뜨린 두 줄에 발판이나 앉을 자리를 달아 거기에 타서 몸을 앞뒤로 왔다 갔다 흔들게 하는 놀이 기구.
그늘	ㄱㅡㄴㅡㄹ	빛이 어떤 물체에 가려져 생긴 어두운 부분.
그담	ㄱㅡㄷㅏㅁ	어떠한 것에 뒤이어 오는 때나 장소, 순서.
그룹	ㄱㅡㄹㅜㅂ	어떤 일을 함께 하는 사람들의 모임.
그릇	ㄱㅡㄹㅡㅅ	음식을 담는 도구.
그릴	ㄱㅡㄹㅣㄹ	고기나 생선을 굽는 석쇠.
그림	ㄱㅡㄹㅣㅁ	선이나 색채로 사물의 모양이나 이미지 등을 평면 위에 나타낸 것.
그물	ㄱㅡㅁㅜㄹ	물고기나 짐승을 잡기 위하여 끈이나 실, 철사 등으로 짠 도구.
그믐	ㄱㅡㅁㅡㅁ	음력으로 한 달의 마지막 날.
그새	ㄱㅡㅅㅏㅣ	어느 때부터 다른 어느 때까지의 비교적 짧은 동안.
그전	ㄱㅡㅈㅓㄴ	과거의 어느 때.
그제	ㄱㅡㅈㅓㅣ	어제의 전날.
그중	ㄱㅡㅈㅜㅇ	일정한 범위 안에 있는 여러 개 가운데.
그해	ㄱㅡㅎㅏㅣ	과거의 어느 해.
극기	ㄱㅡㄱㄱㅣ	감정이나 욕구 등을 의지로 참아 냄.
극도	ㄱㅡㄱㄷㅗ	매우 심한 정도.
극비	ㄱㅡㄱㅂㅣ	절대로 알려져서는 안 되는 비밀.
극소	ㄱㅡㄱㅅㅗ	크기가 지극히 작음.
극우	ㄱㅡㄱㅇㅜ	극단적으로 보수적인 성향. 또는 그런 성향을 가진 사람이나 단체.
극치	ㄱㅡㄱㅊㅣ	도달할 수 있는 최고의 상태.
근거	ㄱㅡㄴㄱㅓ	생활이나 활동 등의 근본이 되는 곳.
근교	ㄱㅡㄴㄱㅛ	도시에 가까운 변두리 지역.
근로	ㄱㅡㄴㄹㅗ	부지런히 일함.
근무	ㄱㅡㄴㅁㅜ	직장에서 맡은 일을 하는 것. 또는 그런 일.
근수	ㄱㅡㄴㅅㅜ	저울로 달아 수치로 나타나는 무게.
근시	ㄱㅡㄴㅅㅣ	가까운 곳에 있는 것은 잘 보나 먼 곳에 있는 것은 선명하게 보지 못하는 시력. 또는 그런 눈.
근저	ㄱㅡㄴㅈㅓ	뿌리나 밑바탕이 되는 기초.
근조	ㄱㅡㄴㅈㅗ	사람의 죽음에 대한 슬픈 마음을 나타냄.
근처	ㄱㅡㄴㅊㅓ	어떤 장소나 물건, 사람을 중심으로 하여 가까운 곳.
글자	ㄱㅡㄹㅈㅏ	말을 적는 기호.
글피	ㄱㅡㄹㅍㅣ	오늘을 기준으로 사흘 뒤에 오는 날. 모레의 다음 날.
금고	ㄱㅡㅁㄱㅗ	도둑이나 재난으로부터 보호하기 위해 돈, 보석, 중요한 서류 등 귀중한 물건을 보관하는 데 사용하는 상자나 창고.
금기	ㄱㅡㅁㄱㅣ	종교 또는 관습적인 이유로 하면 안 되거나 피해야 하는 일.
금녀	ㄱㅡㅁㄴㅕ	여자의 출입을 금하거나 기회를 제한함.
금니	ㄱㅡㅁㄴㅣ	금으로 만든 이.
금리	ㄱㅡㅁㄹㅣ	금융 기관에서 빌린 돈이나 예금에 붙는 이자 또는 그 비율.
금서	ㄱㅡㅁㅅㅓ	국가에 의해 출판 및 판매, 독서, 소유가 법적으로 금지된 책.
금수	ㄱㅡㅁㅅㅜ	모든 짐승.
금주	ㄱㅡㅁㅈㅜ	이번 주일.
금지	ㄱㅡㅁㅈㅣ	법이나 규칙이나 명령으로 어떤 행위를 하지 못하게 함.
급료	ㄱㅡㅂㄹㅛ	일정한 기간 동안 일한 대가로 받는 돈.
급류	ㄱㅡㅂㄹㅠ	물이 빠른 속도로 흐름. 또는 빠르게 흐르는 물.
급보	ㄱㅡㅂㅂㅗ	급히 알리는 것. 또는 급히 알리는 소식.
급사	ㄱㅡㅂㅅㅏ	갑자기 죽는 것, 또는 갑작스러운 죽음.
급서	ㄱㅡㅂㅅㅓ	(높임말로) 갑자기 죽는 것.
급소	ㄱㅡㅂㅅㅗ	조금만 다쳐도 매우 위험해질 수 있는 몸의 중요한 부분.
급수	ㄱㅡㅂㅅㅜ	기술의 수준이나 능력의 높고 낮음을 일정한 기준에 따라 나누어 놓은 등급.
급여	ㄱㅡㅂㅇㅕ	일한 대가로 받는 돈.
급우	ㄱㅡㅂㅇㅜ	같은 반에서 함께 공부하는 친구.
급유	ㄱㅡㅂㅇㅠ	비행기, 배, 자동차 등에 연료를 공급함.
급조	ㄱㅡㅂㅈㅗ	갑자기 서둘러서 대충 만드는 것.
급파	ㄱㅡㅂㅍㅏ	일정한 임무를 띤 사람을 급히 보냄.
긍지	ㄱㅡㅇㅈㅣ	떳떳하고 자랑스럽게 여기는 마음.
기각	ㄱㅣㄱㅏㄱ	법원이 법적으로 내어진 문제나 안건 등을 이유가 없다고 판단하여 받아들이지 않기로 결정하는 일.
기간	ㄱㅣㄱㅏㄴ	어떤 분야에서 가장 기본이 되거나 중심이 되는 부분.
기갈	ㄱㅣㄱㅏㄹ	배고픔과 목마름.
기강	ㄱㅣㄱㅏㅇ	어떤 집단이나 사회의 규율과 질서.
기개	ㄱㅣㄱㅏㅣ	굳은 의지와 씩씩한 정신.
기겁	ㄱㅣㄱㅓㅂ	숨이 막힐 듯이 갑자기 놀라거나 겁에 질림.
기계	ㄱㅣㄱㅕㅣ	일정한 일을 하는 도구나 장치.
기골	ㄱㅣㄱㅗㄹ	튼튼하고 건장한 체격.
기공	ㄱㅣㄱㅗㅇ	기술을 가지고 기계 등을 수리하거나 제작하는 노동자. 기술공.
기근	ㄱㅣㄱㅡㄴ	먹을 양식이 모자라 굶주림.
기금	ㄱㅣㄱㅡㅁ	공공의 목적이나 사업, 행사 등에 쓰기 위해 모은 돈.
기내	ㄱㅣㄴㅏㅣ	비행기의 안.
기념	ㄱㅣㄴㅕㅁ	훌륭한 인물이나 특별한 일 등을 오래도록 잊지 않고 마음에 간직함.
기능	ㄱㅣㄴㅡㅇ	작업을 정확하고 손쉽게 해 주는 기술적인 재주와 능력.
기대	ㄱㅣㄷㅏㅣ	어떤 일이 이루어지기를 바라며 기다림.
기동	ㄱㅣㄷㅗㅇ	몸을 일으켜 움직임.
기둥	ㄱㅣㄷㅜㅇ	건축물에서 천장이나 지붕처럼 윗부분에 올리는 구조물을 떠받치는 긴 구조물.
기량	ㄱㅣㄹㅑㅇ	기술적인 재주나 솜씨.
기력	ㄱㅣㄹㅕㄱ	활동을 할 수 있는 정신적, 육체적 힘.
기록	ㄱㅣㄹㅗㄱ	주로 후일에 남길 목적으로 어떤 사실이나 생각을 적거나 영상으로 남김. 또는 그런 글이나 영상.
기뢰	ㄱㅣㄹㅗㅣ	적의 함선을 파괴하기 위하여 물속이나 물 위에 설치한 폭탄.
기름	ㄱㅣㄹㅡㅁ	불에 잘 타고 물에 잘 섞이지 않는 미끈미끈한 액체.
기린	ㄱㅣㄹㅣㄴ	이마 양쪽에 짧은 뿔이 있으며 목과 다리가 아주 긴 동물.
기립	ㄱㅣㄹㅣㅂ	자리에서 일어나서 섬.
기만	ㄱㅣㅁㅏㄴ	남을 속임.
기말	ㄱㅣㅁㅏㄹ	기간 또는 학기의 끝.
기물	ㄱㅣㅁㅜㄹ	그릇이나 가구 등과 같이 일상생활에 쓰는 여러 가지 물건.
기밀	ㄱㅣㅁㅣㄹ	남이 절대로 알아서는 안 되는 아주 중요한 비밀.
기반	ㄱㅣㅂㅏㄴ	무엇을 하기 위해 기초가 되는 것.
기법	ㄱㅣㅂㅓㅂ	기교와 방법.
기벽	ㄱㅣㅂㅕㄱ	남들과는 다른 특이하고 이상한 버릇.
기별	ㄱㅣㅂㅕㄹ	다른 곳에 있는 사람에게 소식을 전함. 또는 그 소식.
기병	ㄱㅣㅂㅕㅇ	말을 타고 싸우는 병사.
기복	ㄱㅣㅂㅗㄱ	신에게 복을 내려 달라고 비는 것.
기본	ㄱㅣㅂㅗㄴ	무엇을 하기 전에 가장 먼저 해야 하는 것이나 꼭 있어야 하는 것.
기분	ㄱㅣㅂㅜㄴ	불쾌, 유쾌, 우울, 분노 등의 감정 상태.
기상	ㄱㅣㅅㅏㅇ	바람, 비, 구름, 눈 등의 대기 속에서 일어나는 현상.
기선	ㄱㅣㅅㅓㄴ	증기 기관의 힘으로 움직이는 배.
기성	ㄱㅣㅅㅓㅇ	이미 이루어져 있는 것.
기세	ㄱㅣㅅㅓㅣ	힘차게 뻗치는 기운이나 세력.
기술	ㄱㅣㅅㅜㄹ	과학 이론을 실제로 적용하여 인간 생활에 쓸모가 있게 하는 수단.
기습	ㄱㅣㅅㅡㅂ	적이 생각지 않았던 때에, 갑자기 들이쳐 공격함. 또는 그런 공격.
기승	ㄱㅣㅅㅡㅇ	성격이 강하고 사나워 좀처럼 굽히지 않음. 또는 그 성격.
기실	ㄱㅣㅅㅣㄹ	실제의 사정.
기악	ㄱㅣㅇㅏㄱ	악기로 연주하는 음악.
기안	ㄱㅣㅇㅏㄴ	사업이나 활동을 하기 위하여 처음으로 대강 세운 계획을 문서로 만드는 일. 또는 그러한 계획.
기암	ㄱㅣㅇㅏㅁ	이상하게 생긴 바위.
기압	ㄱㅣㅇㅏㅂ	공기의 무게로 인해 생기는 압력.
기약	ㄱㅣㅇㅑㄱ	때를 정하여 약속함. 또는 그런 약속.
기억	ㄱㅣㅇㅓㄱ	이전의 모습, 사실, 지식, 경험 등을 잊지 않거나 다시 생각해 냄.
기업	ㄱㅣㅇㅓㅂ	이윤을 얻기 위해 생산, 판매, 유통 등의 경제 활동을 하는 조직체.
기역	ㄱㅣㅇㅕㄱ	한글 자모 ‘ㄱ’의 이름.
기염	ㄱㅣㅇㅕㅁ	매우 강하고 맹렬한 기세.
기예	ㄱㅣㅇㅕㅣ	무술이나 예술 등에서의 뛰어난 재주와 기술.
기온	ㄱㅣㅇㅗㄴ	대기의 온도.
기와	ㄱㅣㅇㅗㅏ	흙이나 시멘트, 금속 등의 재료를 사용하여 넓적하게 만들어서 지붕을 덮는 데 쓰는 물건.
기용	ㄱㅣㅇㅛㅇ	능력 있는 사람을 중요한 자리에 뽑아 씀.
기운	ㄱㅣㅇㅜㄴ	생물이 몸을 움직이고 활동하는 힘.
기인	ㄱㅣㅇㅣㄴ	말이나 행동, 성격 등이 보통 사람과 매우 다른 특이한 사람.
기일	ㄱㅣㅇㅣㄹ	사람이 죽은 후 일 년에 한 번씩 제사를 지내는 날.
기입	ㄱㅣㅇㅣㅂ	어떤 사실을 정해진 문서나 노트 등에 씀.
기장	ㄱㅣㅈㅏㅇ	옷의 길이.
기재	ㄱㅣㅈㅏㅣ	어떤 사실을 문서 등에 씀.
기적	ㄱㅣㅈㅓㄱ	평범한 사람들의 지식이나 생각으로는 설명할 수 없을 만큼 이상하고 놀라운 일.
기절	ㄱㅣㅈㅓㄹ	심하게 놀라거나 충격을 받아 일시적으로 정신을 잃고 쓰러짐.
기점	ㄱㅣㅈㅓㅁ	어떤 일이 처음 시작되는 시간이나 곳.
기제	ㄱㅣㅈㅓㅣ	사람이 어떤 행동을 하게 하는 심리 작용이나 원리.
기존	ㄱㅣㅈㅗㄴ	이미 존재함.
기종	ㄱㅣㅈㅗㅇ	비행기의 종류.
기준	ㄱㅣㅈㅜㄴ	구별하거나 정도를 판단하기 위하여 그것과 비교하도록 정한 대상이나 잣대.
기증	ㄱㅣㅈㅡㅇ	남을 위하여 자신의 물품이나 재산, 장기 등을 대가 없이 줌.
기진	ㄱㅣㅈㅣㄴ	힘을 모두 써서 지침.
기질	ㄱㅣㅈㅣㄹ	개인이나 집단이 가지고 있는 특별한 성질.
기척	ㄱㅣㅊㅓㄱ	누가 있는 것을 짐작하게 하는 소리나 표시.
기체	ㄱㅣㅊㅓㅣ	일정한 모양이나 부피가 없고 널리 퍼지려는 성질이 있어 자유롭게 떠서 돌아다니는 물질.
기축	ㄱㅣㅊㅜㄱ	사회나 조직, 세력 등의 중심이 되는 중요한 부분.
기층	ㄱㅣㅊㅡㅇ	대기가 이루는 층.
기침	ㄱㅣㅊㅣㅁ	폐에서 목구멍을 통해 공기가 거친 소리를 내며 갑자기 터져 나오는 일.
기탄	ㄱㅣㅌㅏㄴ	어렵고 불편하게 여겨 감추거나 피함.
기틀	ㄱㅣㅌㅡㄹ	어떤 일의 기본이 되는 조건이나 바탕.
기폭	ㄱㅣㅍㅗㄱ	압력이나 열 등을 받아 폭발을 일으키는 일.
기품	ㄱㅣㅍㅜㅁ	어떤 사람이나 사물에서 드러나는 격이 높고 훌륭한 분위기.
기풍	ㄱㅣㅍㅜㅇ	어떤 집단이나 사회를 지배하는 공통적인 분위기.
기한	ㄱㅣㅎㅏㄴ	미리 정해 놓은 시기.
기함	ㄱㅣㅎㅏㅁ	몸의 힘을 모두 잃음.
기합	ㄱㅣㅎㅏㅂ	힘과 정신을 모으기 위해 내는 큰 소리.
기혈	ㄱㅣㅎㅕㄹ	사람의 몸 속에 흐르는 기운과 피.
기형	ㄱㅣㅎㅕㅇ	사물의 구조나 생김새 등이 정상과 다른 모양.
기혼	ㄱㅣㅎㅗㄴ	이미 결혼함.
기화	ㄱㅣㅎㅗㅏ	액체가 기체로 변함.
기회	ㄱㅣㅎㅗㅣ	어떤 일을 하기에 알맞은 시기나 경우.
길가	ㄱㅣㄹㄱㅏ	길의 양쪽 가장자리.
길이	ㄱㅣㄹㅇㅣ	무엇의 한쪽 끝에서 다른 쪽 끝까지의 거리.
길조	ㄱㅣㄹㅈㅗ	좋은 일이 생길 징조.
김치	ㄱㅣㅁㅊㅣ	배추나 무 등의 채소를 소금에 절인 후 양념에 버무려 발효시켜서 만든 음식.
깁스	ㄱㅣㅂㅅㅡ	금이 가거나 부러진 뼈를 고정시키기 위해 붕대를 감고 석고를 바르는 것.
깊이	ㄱㅣㅍㅇㅣ	위에서 밑바닥까지 또는 겉에서 속까지의 거리.
까치	ㄱㄱㅏㅊㅣ	머리에서 등까지는 검고 윤이 나며 어깨와 배는 흰, 사람의 집 근처에 사는 새.
꼬리	ㄱㄱㅗㄹㅣ	동물의 몸뚱이의 뒤 끝에 달려 있거나 나와 있는 부분.
꼬마	ㄱㄱㅗㅁㅏ	(귀엽게 이르는 말로) 어린아이.
꼬치	ㄱㄱㅗㅊㅣ	나무나 쇠로 만든, 한쪽 끝이 뾰족한 가늘고 긴 막대기에 꿰어 만든 음식.
꽝	ㄱㄱㅗㅏㅇ	제비뽑기 등에서 아무 이득이 없는 것.
꾐	ㄱㄱㅗㅣㅁ	주로 좋지 않은 일을 하도록 다른 사람을 속이거나 부추기는 것.
꿩	ㄱㄱㅜㅓㅇ	닭과 비슷한 크기에 꼬리가 길고, 여러 가지 색을 가진 깃털에 검은 점이 있는 새.
끼니	ㄱㄱㅣㄴㅣ	매일 일정한 시간에 식사로 음식을 먹음. 또는 그런 음식.
나귀	ㄴㅏㄱㅜㅣ	말과 비슷하지만 몸이 말보다 작고 귀가 크며 앞머리에 긴 털이 없는 동물.
나날	ㄴㅏㄴㅏㄹ	계속되는 하루하루.
나락	ㄴㅏㄹㅏㄱ	쌀을 열매로 맺는 농작물.
나목	ㄴㅏㅁㅗㄱ	잎이 다 떨어지고 가지만 앙상하게 남은 나무.
나물	ㄴㅏㅁㅜㄹ	고사리, 도라지 등의 사람이 먹을 수 있는 풀이나 나뭇잎.
나발	ㄴㅏㅂㅏㄹ	위는 가늘고 길며 끝은 넓게 퍼진 모양의, 입으로 바람을 불어 넣어 소리를 내는 옛날의 관악기.
나방	ㄴㅏㅂㅏㅇ	나비와 비슷하나 몸이 더 통통하고 주로 밤에 날아다니며, 식물에 해를 끼치는 벌레 알을 낳는 곤충.
나병	ㄴㅏㅂㅕㅇ	눈썹이 빠지고 살이 썩어 손발이나 얼굴이 변형되며 눈이 잘 보이지 않게 되는 전염병.
나선	ㄴㅏㅅㅓㄴ	겉모양이 소라 껍데기처럼 한 방향으로 빙빙 돌면서 꼬인 것.
나신	ㄴㅏㅅㅣㄴ	아무것도 입지 않은 몸.
나열	ㄴㅏㅇㅕㄹ	차례대로 죽 벌여 늘어놓음.
나인	ㄴㅏㅇㅣㄴ	(옛날에) 궁궐에서 왕과 왕비를 가까이에서 모시던 여자.
나졸	ㄴㅏㅈㅗㄹ	(옛날에) 마을을 순찰하고 죄인을 잡아들이는 일을 맡아 하던 계급이 낮은 군인.
나중	ㄴㅏㅈㅜㅇ	일정한 시간이 지난 뒤.
나체	ㄴㅏㅊㅓㅣ	아무 것도 입지 않은 벌거벗은 몸.
나태	ㄴㅏㅌㅏㅣ	행동이나 성격이 느리고 게으름.
나팔	ㄴㅏㅍㅏㄹ	위는 가늘고 길며 끝은 넓게 퍼진 모양의, 입으로 바람을 불어 넣어 소리를 내는 금속의 관악기.
나흘	ㄴㅏㅎㅡㄹ	네 날.
낙서	ㄴㅏㄱㅅㅓ	글이나 그림을 장난으로 아무 데나 함부로 쓰거나 그림. 또는 그러한 글이나 그림.
낙수	ㄴㅏㄱㅅㅜ	지붕 끝에서 물이 떨어지는 일. 또는 그 물.
낙오	ㄴㅏㄱㅇㅗ	목적지로 함께 가는 사람들의 무리에서 뒤처지는 것.
낙조	ㄴㅏㄱㅈㅗ	저녁에 지는 해와 그 주위로 퍼지는 붉은빛.
낙지	ㄴㅏㄱㅈㅣ	문어와 생김새가 비슷하며 뼈가 없는 회색 몸에 빨판이 달린 여덟 개의 긴 다리가 있고 위험할 때 먹물을 뿜는 바다 동물.
낙차	ㄴㅏㄱㅊㅏ	물이 높은 곳에서 낮은 곳으로 떨어질 때 생기는 위치의 차이.
낙타	ㄴㅏㄱㅌㅏ	사막 지대에서 사람이 타거나 짐을 나르는 데 쓰이는, 등에 큰 혹이 있는 동물.
낙하	ㄴㅏㄱㅎㅏ	높은 곳에서 낮은 곳으로 떨어짐.
낙후	ㄴㅏㄱㅎㅜ	기술, 문화, 생활 등이 일정한 기준에 미치지 못하고 뒤떨어짐.
난로	ㄴㅏㄴㄹㅗ	가스, 석유, 장작 등을 연료로 때거나 전기를 이용하여 실내를 따뜻하게 하는 기구.
난류	ㄴㅏㄴㄹㅠ	따뜻한 바닷물의 흐름.
난리	ㄴㅏㄴㄹㅣ	전쟁이나 나라 안에서 일어난 싸움.
난무	ㄴㅏㄴㅁㅜ	뒤섞여 어지럽게 춤을 춤. 또는 그렇게 추는 춤.
난사	ㄴㅏㄴㅅㅏ	활이나 총 등을 목표물에 정확히 향하게 하지 않고 아무 곳에나 마구 쏨.
난소	ㄴㅏㄴㅅㅗ	동물의 암컷의 생식 기관으로 난자를 만들어 여성 호르몬을 분비하는 생식 기관.
난시	ㄴㅏㄴㅅㅣ	눈의 각막 면이 평평하지 않아 사물을 명확하게 볼 수 없는 상태. 또는 그런 상태의 눈.
난자	ㄴㅏㄴㅈㅏ	수정을 통하여 동식물의 종족을 번식하는 암컷의 생식 세포.
난조	ㄴㅏㄴㅈㅗ	정상적인 상태에서 벗어나거나 조화를 잃은 상태.
난초	ㄴㅏㄴㅊㅗ	잎이 길고 가늘며 향기로운 꽃이 피는 식물.
난치	ㄴㅏㄴㅊㅣ	병을 고치기 어려움.
난타	ㄴㅏㄴㅌㅏ	마구 치거나 때림.
난투	ㄴㅏㄴㅌㅜ	여러 사람이 서로 뒤섞여 어지럽게 싸움.
난파	ㄴㅏㄴㅍㅏ	배가 폭풍우나 암초 등을 만나 부서지거나 뒤집힘.
날수	ㄴㅏㄹㅅㅜ	날의 수.
날조	ㄴㅏㄹㅈㅗ	사실이 아닌 것을 사실인 것처럼 거짓으로 꾸며 냄.
날치	ㄴㅏㄹㅊㅣ	몸이 가늘고 길며 커다란 가슴지느러미를 이용하여 물 위로 날아오르는 바닷물고기.
남녀	ㄴㅏㅁㄴㅕ	남자와 여자.
남도	ㄴㅏㅁㄷㅗ	남과 북으로 되어 있는 도에서, 남쪽에 있는 도.
남루	ㄴㅏㅁㄹㅜ	때 묻고 낡은 더러운 옷.
남미	ㄴㅏㅁㅁㅣ	아메리카 대륙의 남부로 육대주의 하나. 브라질, 아르헨티나, 칠레, 콜롬비아 등의 나라가 있다.
남부	ㄴㅏㅁㅂㅜ	어떤 지역의 남쪽.
남비	ㄴㅏㅁㅂㅣ	→ 냄비
남서	ㄴㅏㅁㅅㅓ	남쪽과 서쪽 사이의 방향.
남아	ㄴㅏㅁㅇㅏ	남자인 아이.
남우	ㄴㅏㅁㅇㅜ	남자 배우.
남자	ㄴㅏㅁㅈㅏ	남성으로 태어난 사람.
남파	ㄴㅏㅁㅍㅏ	임무를 주어 남쪽으로 보냄.
남포	ㄴㅏㅁㅍㅗ	석유를 넣은 그릇의 심지에 불을 붙이고 유리를 씌운 등.
남하	ㄴㅏㅁㅎㅏ	남쪽으로 내려감.
납기	ㄴㅏㅂㄱㅣ	세금이나 공과금 등을 내는 시기나 기한.
납부	ㄴㅏㅂㅂㅜ	세금이나 등록금 등을 국가 또는 공공 기관에 냄.
납치	ㄴㅏㅂㅊㅣ	강제적인 수단으로 사람을 억지로 끌어감.
낭보	ㄴㅏㅇㅂㅗ	기쁘고 반가운 소식.
낭비	ㄴㅏㅇㅂㅣ	돈, 시간, 물건 등을 헛되이 함부로 씀.
낭자	ㄴㅏㅇㅈㅏ	(옛날에) 결혼하지 않은 성인 여자를 높여 이르던 말.
낱자	ㄴㅏㅌㅈㅏ	음절을 이루는 하나하나의 글자.
내규	ㄴㅏㅣㄱㅠ	개별 단체나 조직에서 그 실정에 따라 내부에서만 시행할 목적으로 만든 규정.
내기	ㄴㅏㅣㄱㅣ	걸어 놓은 물품이나 돈을 이긴 사람이 갖기로 미리 약속을 하고 승부를 겨룸.
내부	ㄴㅏㅣㅂㅜ	사물의 안쪽 공간.
내사	ㄴㅏㅣㅅㅏ	어떤 사람이나 조직에 대하여 죄가 있는지 몰래 조사함.
내수	ㄴㅏㅣㅅㅜ	국내의 수요.
내시	ㄴㅏㅣㅅㅣ	옛날에 궁궐에서 임금의 시중을 들던, 거세된 남자.
내야	ㄴㅏㅣㅇㅑ	야구에서 본루, 일루, 이루, 삼루를 이은 선 안.
내조	ㄴㅏㅣㅈㅗ	아내가 남편을 도움.
내주	ㄴㅏㅣㅈㅜ	바로 다음 주.
내지	ㄴㅏㅣㅈㅣ	해안이나 변두리로부터 안쪽으로 깊이 들어간 지역.
내치	ㄴㅏㅣㅊㅣ	나라 안을 다스리는 것.
내포	ㄴㅏㅣㅍㅗ	어떤 뜻이나 성질 등을 속에 가짐.
내피	ㄴㅏㅣㅍㅣ	속껍질. 또는 속가죽.
너와	ㄴㅓㅇㅗㅏ	기와처럼 쓰는 얇은 돌 조각이나 나뭇조각.
너울	ㄴㅓㅇㅜㄹ	바다의 크고 사나운 물결.
넘버	ㄴㅓㅁㅂㅓ	번호나 차례, 또는 그 숫자.
넙치	ㄴㅓㅂㅊㅣ	몸길이가 60센티미터 정도되고 아주 납작하여 한 쪽은 희고 한 쪽은 검은 갈색이며 눈은 두 개가 모두 몸의 검은 쪽에 있는 바닷물고기.
넝마	ㄴㅓㅇㅁㅏ	낡고 해어져서 입지 못하게 된 옷가지.
네모	ㄴㅓㅣㅁㅗ	네 개의 모서리.
네트	ㄴㅓㅣㅌㅡ	배구, 테니스, 탁구, 배드민턴 등에서 경기장의 한 가운데에 쳐서 두 편의 경계를 짓는 그물.
노년	ㄴㅗㄴㅕㄴ	늙은 나이. 또는 늙은 때.
노동	ㄴㅗㄷㅗㅇ	사람이 필요한 음식이나 물자를 얻기 위하여 육체적으로나 정신적으로 하는 일.
노랑	ㄴㅗㄹㅏㅇ	바나나나 레몬과 같은 색.
노래	ㄴㅗㄹㅏㅣ	운율에 맞게 지은 가사에 곡을 붙인 음악. 또는 그런 음악을 소리 내어 부름.
노력	ㄴㅗㄹㅕㄱ	어떤 목적을 이루기 위하여 힘을 들이고 애를 씀.
노령	ㄴㅗㄹㅕㅇ	늙은 나이.
노름	ㄴㅗㄹㅡㅁ	돈 또는 재물을 걸고 화투, 트럼프, 마작 등으로 내기를 함.
노릇	ㄴㅗㄹㅡㅅ	(낮잡아 이르는 말로) 직업으로 하는 일이나 직책을 맡아 하는 역할.
노망	ㄴㅗㅁㅏㅇ	늙어서 정신이 흐려지고 말이나 행동이 정상이 아닌 상태.
노면	ㄴㅗㅁㅕㄴ	길의 바닥.
노변	ㄴㅗㅂㅕㄴ	길의 양쪽 가장자리.
노병	ㄴㅗㅂㅕㅇ	나이가 많은 병사.
노산	ㄴㅗㅅㅏㄴ	나이가 많은 때에 아기를 낳음.
노상	ㄴㅗㅅㅏㅇ	길 위나 길바닥.
노새	ㄴㅗㅅㅏㅣ	암말과 수나귀 사이에서 난 잡종으로, 나귀와 비슷하게 생긴 집짐승.
노선	ㄴㅗㅅㅓㄴ	버스, 기차, 비행기 등이 정기적으로 오가는 일정한 두 지점 사이의 정해진 길.
노송	ㄴㅗㅅㅗㅇ	늙은 소나무.
노쇠	ㄴㅗㅅㅗㅣ	늙어서 몸의 기운이 약함.
노숙	ㄴㅗㅅㅜㄱ	길이나 공원 등 집 밖에서 잠을 잠.
노승	ㄴㅗㅅㅡㅇ	나이가 많은 중.
노안	ㄴㅗㅇㅏㄴ	나이가 들어서 시력이 나빠짐. 또는 그런 눈.
노역	ㄴㅗㅇㅕㄱ	몹시 힘든 육체적 노동.
노염	ㄴㅗㅇㅕㅁ	몹시 불쾌하여 화가 난 감정.
노예	ㄴㅗㅇㅕㅣ	(옛날에) 물건처럼 사고팔리어 남이 시키는 대로 일을 하는 사람.
노옹	ㄴㅗㅇㅗㅇ	늙은 남자.
노을	ㄴㅗㅇㅡㄹ	해가 뜨거나 질 때 하늘이 붉게 보이는 현상.
노인	ㄴㅗㅇㅣㄴ	나이가 들어 늙은 사람.
노임	ㄴㅗㅇㅣㅁ	노동에 대한 보수.
노작	ㄴㅗㅈㅏㄱ	힘을 들이고 노력해서 이룬 작품.
노장	ㄴㅗㅈㅏㅇ	늙은 장군.
노점	ㄴㅗㅈㅓㅁ	길이나 공터에 임시로 물건을 벌여 놓고 장사하는 곳.
노정	ㄴㅗㅈㅓㅇ	목적지까지의 경로나 일정.
노천	ㄴㅗㅊㅓㄴ	사방이 뚫린 바깥이나 길.
노출	ㄴㅗㅊㅜㄹ	감추어져 있는 것을 남이 보거나 알 수 있도록 겉으로 드러냄.
노친	ㄴㅗㅊㅣㄴ	늙은 부모.
노화	ㄴㅗㅎㅗㅏ	나이가 들며 신체의 구조나 기능이 쇠퇴하는 현상.
녹두	ㄴㅗㄱㄷㅜ	묵, 숙주나물, 빈대떡 등의 재료가 되는 녹색의 작고 동그란 콩.
녹지	ㄴㅗㄱㅈㅣ	자연적으로 풀이나 나무가 많거나 계획적으로 풀이나 나무를 많이 심은 곳.
녹차	ㄴㅗㄱㅊㅏ	차나무의 잎을 딴 후 햇볕에 말린 푸른색 잎. 또는 그 잎으로 만든 차.
녹초	ㄴㅗㄱㅊㅗ	맥이 풀어져 힘을 못 쓰고 축 늘어진 상태.
논거	ㄴㅗㄴㄱㅓ	이론이나 주장의 근거.
논고	ㄴㅗㄴㄱㅗ	자기의 주장이나 신념을 증거를 대며 논술함.
논리	ㄴㅗㄴㄹㅣ	바르게 판단하고 이치에 맞게 생각하는 과정이나 원리.
논자	ㄴㅗㄴㅈㅏ	어떤 의견이나 이론을 주장하는 사람.
논저	ㄴㅗㄴㅈㅓ	어떤 주제에 관한 사실이나 견해를 논하여 책이나 논문을 씀. 또는 그 책이나 논문.
논조	ㄴㅗㄴㅈㅗ	의견을 주장하는 말이나 글에서 감정이나 생각을 드러내는 방식.
논지	ㄴㅗㄴㅈㅣ	어떤 문제에 대해 논하는 말이나 글에서 근본이 되는 목적이나 뜻.
놀부	ㄴㅗㄹㅂㅜ	고전 소설 ‘흥부전’의 주인공 중 한 사람. 흥부의 형으로 욕심이 많고 심술궂다.
놀이	ㄴㅗㄹㅇㅣ	즐겁게 노는 일.
농가	ㄴㅗㅇㄱㅏ	농사에 종사하는 사람의 가정.
농고	ㄴㅗㅇㄱㅗ	‘농업 고등학교’를 줄여 이르는 말.
농구	ㄴㅗㅇㄱㅜ	다섯 사람씩 두 팀이 하며, 상대방의 바스켓에 공을 많이 넣으면 이기는 경기.
농기	ㄴㅗㅇㄱㅣ	말이나 행동에서 보이는 장난스러운 분위기.
농도	ㄴㅗㅇㄷㅗ	기체나 액체에 들어있는 한 성분의 진함과 묽음의 정도.
농무	ㄴㅗㅇㅁㅜ	짙게 낀 안개.
농부	ㄴㅗㅇㅂㅜ	농사 짓는 일을 직업으로 하는 사람.
농사	ㄴㅗㅇㅅㅏ	곡식이나 채소 등을 심고 기르고 거두는 일.
농아	ㄴㅗㅇㅇㅏ	듣지 못하거나 말하지 못하는 사람.
농어	ㄴㅗㅇㅇㅓ	몸이 조금 납작하고 등은 검푸르고 배가 희며 온몸에 잔 비늘이 많은 바닷물고기.
농지	ㄴㅗㅇㅈㅣ	농사를 짓는 땅.
농토	ㄴㅗㅇㅌㅗ	농사짓는 땅.
높이	ㄴㅗㅍㅇㅣ	높은 정도.
뇌리	ㄴㅗㅣㄹㅣ	사람의 의식이나 기억이나 생각이 들어 있는 머릿속.
뇌사	ㄴㅗㅣㅅㅏ	심장 박동 이외에 뇌의 모든 기능이 정지되어 본래의 상태로 되돌아갈 수 없는 상태.
뇌파	ㄴㅗㅣㅍㅏ	뇌가 활동할 때 신경들이 내보내는 전류.
누각	ㄴㅜㄱㅏㄱ	지붕만 있고 문과 벽이 없어 사방을 볼 수 있도록 높이 지은 집.
누계	ㄴㅜㄱㅕㅣ	한 분야에서 여러 작은 합계들을 계속 덧붙여 합한 수치.
누님	ㄴㅜㄴㅣㅁ	(높임말로) 가족이나 친족 관계에서 남자가 자신보다 나이가 위인 여자를 이르거나 부르는 말.
누락	ㄴㅜㄹㅏㄱ	포함되어야 할 부분이 목록이나 기록에서 빠짐.
누룩	ㄴㅜㄹㅜㄱ	술을 빚거나 빵을 만들 때 쓰는 발효제.
누명	ㄴㅜㅁㅕㅇ	사실이 아닌 일로 억울하게 얻은 나쁜 평판.
누설	ㄴㅜㅅㅓㄹ	기체나 액체가 밖으로 새어 나감. 또는 그렇게 함.
누에	ㄴㅜㅇㅓㅣ	뽕잎을 먹고 살며 비단실의 원료가 되는 고치를 지어 그 속에서 살다가 나방이 되는 벌레.
누적	ㄴㅜㅈㅓㄱ	계속 반복되어 쌓임. 또는 계속 반복하여 쌓음.
누전	ㄴㅜㅈㅓㄴ	전기가 전깃줄 밖으로 새어 흐름.
누출	ㄴㅜㅊㅜㄹ	액체나 기체가 밖으로 새어 나오는 것.
눈가	ㄴㅜㄴㄱㅏ	눈의 주변.
눈비	ㄴㅜㄴㅂㅣ	눈과 비. 또는 눈과 비가 섞여 내리는 것.
눈치	ㄴㅜㄴㅊㅣ	상대가 말하지 않아도 그 사람의 마음이나 일의 상황을 이해하고 아는 능력.
능사	ㄴㅡㅇㅅㅏ	자신에게 잘 맞아서 잘해 낼 수 있는 일.
늪가	ㄴㅡㅍㄱㅏ	늪의 가장자리.
늪지	ㄴㅡㅍㅈㅣ	늪이 많은 구역.
니은	ㄴㅣㅇㅡㄴ	한글 자모 ‘ㄴ’의 이름.
다과	ㄷㅏㄱㅗㅏ	수량이 많고 적음.
다단	ㄷㅏㄷㅏㄴ	여러 단.
다독	ㄷㅏㄷㅗㄱ	책을 많이 읽음.
다락	ㄷㅏㄹㅏㄱ	집의 천장과 지붕 사이에 이 층처럼 만들어 물건을 보관하는 공간.
다래	ㄷㅏㄹㅏㅣ	주로 깊은 산속에서 자라며 가을에 손가락 굵기 정도의 푸르고 둥근 열매가 열리는 식물.
다량	ㄷㅏㄹㅑㅇ	많은 분량.
다면	ㄷㅏㅁㅕㄴ	여러 개의 면.
다발	ㄷㅏㅂㅏㄹ	꽃이나 채소, 돈 등의 묶음.
다방	ㄷㅏㅂㅏㅇ	차나 커피, 음료를 사서 마시며 이야기하거나 쉴 수 있는 장소.
다산	ㄷㅏㅅㅏㄴ	아이나 새끼를 많이 낳음.
다승	ㄷㅏㅅㅡㅇ	운동 경기 등에서 여러 번 이김.
다실	ㄷㅏㅅㅣㄹ	사람들이 편히 쉬며 이야기할 수 있게 꾸며 놓고 커피, 차 등의 음료수를 파는 곳.
다운	ㄷㅏㅇㅜㄴ	(속된 말로) 일에 지치거나 좋지 않은 일을 당해서 의욕이나 흥미, 기운을 잃어버림. 또는 그런 상태.
다음	ㄷㅏㅇㅡㅁ	어떤 차례에서 바로 뒤.
다작	ㄷㅏㅈㅏㄱ	작품을 많이 만듦.
다정	ㄷㅏㅈㅓㅇ	마음이 따뜻하고 정이 많음.
다중	ㄷㅏㅈㅜㅇ	여러 겹.
다짐	ㄷㅏㅈㅣㅁ	이미 한 일이나 앞으로 할 일에 틀림이 없음을 단단히 확인함.
다층	ㄷㅏㅊㅡㅇ	여러 층.
다툼	ㄷㅏㅌㅜㅁ	싸우는 일.
다홍	ㄷㅏㅎㅗㅇ	진하고 산뜻한 붉은색.
단가	ㄷㅏㄴㄱㅏ	물건 한 단위의 가격.
단교	ㄷㅏㄴㄱㅛ	서로 사귀어 가까이 지내던 관계를 끊음.
단기	ㄷㅏㄴㄱㅣ	짧은 기간.
단도	ㄷㅏㄴㄷㅗ	칼의 한쪽에 날이 서 있는 길이가 짧은 칼.
단비	ㄷㅏㄴㅂㅣ	꼭 필요한 때에 적당하게 내리는 비.
단서	ㄷㅏㄴㅅㅓ	법률 조문이나 문서 등에서, 본문 다음에 그 내용에 대한 어떤 조건이나 예외 등을 적은 글.
단소	ㄷㅏㄴㅅㅗ	오래된 대나무로 짧고 가늘게 만들어 앞에 넷, 뒤에 하나의 구멍을 뚫은 한국의 전통 관악기.
단수	ㄷㅏㄴㅅㅜ	바둑, 유도, 태권도 등 단으로 등급을 매기는 운동이나 기술에서 그 단의 수.
단어	ㄷㅏㄴㅇㅓ	일정한 뜻과 기능을 가지며 홀로 쓰일 수 있는 가장 작은 말의 단위.
단오	ㄷㅏㄴㅇㅗ	한국의 명절의 하나. 음력 5월 5일로, 여자는 창포물에 머리를 감고 그네뛰기를 하며, 남자는 씨름을 하는 풍습이 있다.
단자	ㄷㅏㄴㅈㅏ	결혼이나 장례 의식 등에서 사용되는 태어난 연월일시나 이름 등을 쓴 종이.
단조	ㄷㅏㄴㅈㅗ	단음계로 된 곡조.
단지	ㄷㅏㄴㅈㅣ	윗부분이 짧고 가운데 부분이 불룩한 작은 항아리.
단초	ㄷㅏㄴㅊㅗ	어떤 사건이나 일의 시작, 또는 사건이나 일이 일어나게 된 동기.
단추	ㄷㅏㄴㅊㅜ	옷을 여미기 위해 사용하는 작고 동그란 물건.
달러	ㄷㅏㄹㄹㅓ	미국의 돈.
달수	ㄷㅏㄹㅅㅜ	몇 달인지 세어 보았을 때 계산된 달의 수.
달포	ㄷㅏㄹㅍㅗ	한 달이 조금 넘는 시간.
담보	ㄷㅏㅁㅂㅗ	빚을 진 사람이 빚을 갚지 않을 경우에 그 빚을 대신할 수 있는 것으로 내놓는 것.
담소	ㄷㅏㅁㅅㅗ	좋은 분위기에서 웃고 즐기며 이야기함. 또는 그런 이야기.
담수	ㄷㅏㅁㅅㅜ	강이나 호수의 물처럼 소금기가 없는 물.
담요	ㄷㅏㅁㅇㅛ	털 등으로 짜서 덮거나 깔도록 만든 얇은 이불.
답보	ㄷㅏㅂㅂㅗ	상태가 더 나아가지 못하고 계속 그 자리에 있음. 또는 그런 상태.
답사	ㄷㅏㅂㅅㅏ	식장에서 축사, 환영사, 환송사 등에 답하여 하는 말.
답지	ㄷㅏㅂㅈㅣ	문제에 대한 답을 쓴 종이.
당구	ㄷㅏㅇㄱㅜ	네모난 대 위에 공을 놓고 긴 막대기로 쳐서 맞히는 것으로 이기고 지는 것을 가리는 실내 놀이.
당뇨	ㄷㅏㅇㄴㅛ	오줌에 당분이 비정상적으로 많이 섞여 나오는 병.
당도	ㄷㅏㅇㄷㅗ	음식물의 단맛의 정도.
당류	ㄷㅏㅇㄹㅠ	포도당, 과당, 전분 등 물에 잘 녹으며 단맛이 있는 탄수화물.
당부	ㄷㅏㅇㅂㅜ	꼭 해 줄 것을 말로 단단히 부탁함. 또는 그런 부탁.
당사	ㄷㅏㅇㅅㅏ	이 회사.
당시	ㄷㅏㅇㅅㅣ	어떤 일이 일어나던 그 시기. 또는 앞에서 말한 그 시기.
당초	ㄷㅏㅇㅊㅗ	일의 제일 처음.
당파	ㄷㅏㅇㅍㅏ	정치적 목적이나 주장이 같은 사람들이 모여서 이룬 단체.
대가	ㄷㅏㅣㄱㅏ	전문 분야에서 능력이 뛰어나 권위를 인정받는 사람.
대거	ㄷㅏㅣㄱㅓ	한꺼번에 많은 수.
대교	ㄷㅏㅣㄱㅛ	큰 다리.
대구	ㄷㅏㅣㄱㅜ	엷은 회갈색에 배는 흰색이고 입이 크며 비늘이 작고 둥근 바닷물고기.
대기	ㄷㅏㅣㄱㅣ	지구를 둘러싸고 있는 모든 공기.
대도	ㄷㅏㅣㄷㅗ	값비싼 물건이나 큰돈을 훔치는 도둑.
대두	ㄷㅏㅣㄷㅜ	두유, 두부 등의 재료로, 노란색 또는 검은색의 얇은 껍질에 쌓인 동그란 모양의 곡식.
대로	ㄷㅏㅣㄹㅗ	크고 넓은 길.
대리	ㄷㅏㅣㄹㅣ	다른 사람을 대신하여 일을 처리함.
대모	ㄷㅏㅣㅁㅗ	어머니의 역할을 대신해 주는 여자.
대미	ㄷㅏㅣㅁㅣ	중요한 일의 맨 마지막.
대부	ㄷㅏㅣㅂㅜ	매우 부유한 부자.
대비	ㄷㅏㅣㅂㅣ	두 가지의 차이를 알아보기 위해 서로 비교함. 또는 그런 비교.
대사	ㄷㅏㅣㅅㅏ	다루는 데 힘이 많이 들고 중요한 일.
대서	ㄷㅏㅣㅅㅓ	일 년 중 가장 무덥다는 날로 이십사절기의 하나. 7월 24일경이다.
대소	ㄷㅏㅣㅅㅗ	크거나 작은 것을 함께 이르는 말.
대수	ㄷㅏㅣㅅㅜ	중요한 것. 또는 대단한 것.
대시	ㄷㅏㅣㅅㅣ	이미 말한 내용을 다른 말로 설명을 덧붙이거나 보충할 때에 쓰는 문장 부호 ‘―’의 이름.
대야	ㄷㅏㅣㅇㅑ	주로 세수할 때 물을 담아 쓰는 둥글고 넓적한 그릇.
대어	ㄷㅏㅣㅇㅓ	큰 물고기.
대여	ㄷㅏㅣㅇㅕ	물건이나 돈을 빌려줌.
대오	ㄷㅏㅣㅇㅗ	크게 깨달음.
대우	ㄷㅏㅣㅇㅜ	사람을 대하거나 다루는 일정한 태도나 방식.
대자	ㄷㅏㅣㅈㅏ	팔과 다리를 양쪽으로 크게 뻗은 모습.
대조	ㄷㅏㅣㅈㅗ	둘 이상의 것을 맞대어 같고 다름을 살펴봄.
대지	ㄷㅏㅣㅈㅣ	대자연의 넓은 땅.
대처	ㄷㅏㅣㅊㅓ	어떤 어려운 일이나 상황을 이겨 내기에 알맞게 행동함.
대추	ㄷㅏㅣㅊㅜ	맛이 달고 익으면 껍질이 붉어지는, 작은 새알 같이 생긴 열매.
대치	ㄷㅏㅣㅊㅣ	다른 것으로 바꾸어 놓음.
대타	ㄷㅏㅣㅌㅏ	야구에서 원래 정해져 있던 타자를 대신해서 공을 치는 사람.
대파	ㄷㅏㅣㅍㅏ	줄기가 길고 굵은 파.
대포	ㄷㅏㅣㅍㅗ	별 안주 없이 큰 그릇에 따라 마시는 술.
대표	ㄷㅏㅣㅍㅛ	전체의 상태나 특징을 어느 하나로 잘 나타냄. 또는 그런 것.
대피	ㄷㅏㅣㅍㅣ	위험을 피해 잠깐 안전한 곳으로 감.
더덕	ㄷㅓㄷㅓㄱ	독특한 향기와 맛이 있어 식재료나 약재로 사용되는, 산이나 들에서 나는 식물의 뿌리.
더블	ㄷㅓㅂㅡㄹ	두 배. 두 겹.
더빙	ㄷㅓㅂㅣㅇ	외국 영화의 대사를 해당 언어로 바꾸어 성우의 목소리로 다시 녹음하는 일.
더위	ㄷㅓㅇㅜㅣ	여름철의 더운 기운. 더운 날씨.
덜미	ㄷㅓㄹㅁㅣ	목의 뒤쪽 부분.
덧니	ㄷㅓㅅㄴㅣ	다른 이 위에 겹쳐 나서 앞으로 조금 나가 있는 이.
덩이	ㄷㅓㅇㅇㅣ	같은 물질이 작게 뭉쳐서 이루어진 것.
덩치	ㄷㅓㅇㅊㅣ	몸의 크기나 부피.
데모	ㄷㅓㅣㅁㅗ	어떤 의견을 널리 알리기 위해 여러 사람이 한데 모여 구호를 외치거나 집단적으로 행동함.
도감	ㄷㅗㄱㅏㅁ	그림이나 사진을 모아 실물 대신 볼 수 있도록 엮은 책.
도강	ㄷㅗㄱㅏㅇ	대학에서 강의를 신청하지 않고 몰래 들음.
도공	ㄷㅗㄱㅗㅇ	흙을 빚어 그릇이나 도자기를 만드는 일을 직업으로 하는 사람.
도굴	ㄷㅗㄱㅜㄹ	광물이나 무덤 속의 유물을 불법적으로 몰래 파내는 짓.
도금	ㄷㅗㄱㅡㅁ	물체의 겉에 금이나 은과 같은 금속을 얇게 입힘.
도급	ㄷㅗㄱㅡㅂ	일정한 기간이나 시간 안에 끝내야 할 양의 일을 한꺼번에 맡거나 맡김. 또는 그렇게 맡거나 맡긴 일.
도끼	ㄷㅗㄱㄱㅣ	굵은 나무를 찍거나 장작을 패는 데 쓰는 연장.
도난	ㄷㅗㄴㅏㄴ	도둑을 맞음.
도넛	ㄷㅗㄴㅓㅅ	밀가루를 반죽하여 고리 모양으로 만들어 기름에 튀긴 과자.
도농	ㄷㅗㄴㅗㅇ	도시와 농촌.
도달	ㄷㅗㄷㅏㄹ	목적한 곳이나 일정한 수준에 다다름.
도덕	ㄷㅗㄷㅓㄱ	한 사회의 사람들이 말, 행동, 믿음의 좋고 나쁨을 판단하는 정신적 기준이나 가치 체계.
도둑	ㄷㅗㄷㅜㄱ	남의 물건을 훔치거나 빼앗는 짓.
도랑	ㄷㅗㄹㅏㅇ	폭이 좁고 작은 개울.
도래	ㄷㅗㄹㅏㅣ	어떤 시기나 기회가 옴.
도량	ㄷㅗㄹㅑㅇ	너그럽게 받아들이고 깊게 이해할 수 있는 마음과 생각.
도령	ㄷㅗㄹㅕㅇ	(대접하는 말로) 결혼하지 않은 성인 남자.
도록	ㄷㅗㄹㅗㄱ	그림 또는 사진을 모아 만든 책.
도륙	ㄷㅗㄹㅠㄱ	사람 또는 동물을 함부로 잔인하게 죽임.
도립	ㄷㅗㄹㅣㅂ	공공의 이익을 위하여 도의 예산으로 설립하고 관리함.
도막	ㄷㅗㅁㅏㄱ	짧고 작은 덩어리.
도망	ㄷㅗㅁㅏㅇ	피하거나 쫓기어 달아남.
도매	ㄷㅗㅁㅏㅣ	물건을 낱개로 사지 않고 여러 개를 한꺼번에 사는 것.
도면	ㄷㅗㅁㅕㄴ	토목, 건축, 기계 등의 구조나 설계 등을 나타낸 그림.
도민	ㄷㅗㅁㅣㄴ	행정 구역상으로 같은 도 안에 사는 사람.
도박	ㄷㅗㅂㅏㄱ	돈 또는 재물을 걸고 화투, 트럼프, 마작 등으로 내기를 함.
도발	ㄷㅗㅂㅏㄹ	상대를 자극해 어떤 일이 일어나게 함.
도배	ㄷㅗㅂㅏㅣ	색깔과 무늬가 있는 종이를 벽이나 천장에 붙이는 일.
도벽	ㄷㅗㅂㅕㄱ	남의 물건을 훔치는 버릇.
도복	ㄷㅗㅂㅗㄱ	유도, 태권도 등의 운동을 할 때 입는 옷.
도산	ㄷㅗㅅㅏㄴ	기업이나 회사 등이 운영을 계속할 돈이 없어 망함.
도살	ㄷㅗㅅㅏㄹ	사람을 마구 죽임.
도성	ㄷㅗㅅㅓㅇ	성으로 이루어진 한 나라의 수도. 서울.
도술	ㄷㅗㅅㅜㄹ	도를 닦아서 얻게 된 능력으로 부리는 기이한 기술.
도식	ㄷㅗㅅㅣㄱ	어떤 것의 구조나 상태, 관계 등을 쉽게 보이기 위하여 나타낸 표나 그림.
도심	ㄷㅗㅅㅣㅁ	도시의 중심.
도안	ㄷㅗㅇㅏㄴ	미술 작품을 만들 때의 모양, 색채, 배치 등에 관한 계획을 그림으로 나타낸 것.
도약	ㄷㅗㅇㅑㄱ	몸을 공중으로 날려 힘차게 뛰어오름.
도열	ㄷㅗㅇㅕㄹ	여러 사람이 길게 줄지어 섬. 또는 그런 행렬.
도예	ㄷㅗㅇㅕㅣ	‘도자기 공예’를 줄여 이르는 말.
도용	ㄷㅗㅇㅛㅇ	남의 것을 허락 없이 몰래 씀.
도움	ㄷㅗㅇㅜㅁ	다른 사람을 돕는 일.
도읍	ㄷㅗㅇㅡㅂ	한 나라의 중앙 정부가 있는 곳.
도의	ㄷㅗㅇㅡㅣ	사람이 지키고 따라야 할 도덕적 원칙.
도인	ㄷㅗㅇㅣㄴ	도를 닦아 큰 이치를 깨달은 사람.
도입	ㄷㅗㅇㅣㅂ	지식, 기술, 물자 등을 들여옴.
도장	ㄷㅗㅈㅏㅇ	무예를 연습하거나 가르치는 곳.
도적	ㄷㅗㅈㅓㄱ	남의 물건을 훔치거나 빼앗는 짓을 하는 사람.
도전	ㄷㅗㅈㅓㄴ	정면으로 맞서서 싸움을 걺.
도정	ㄷㅗㅈㅓㅇ	지방 자치 단체인 도의 행정.
도제	ㄷㅗㅈㅓㅣ	선생이나 스승에게 무엇을 배우는 사람.
도중	ㄷㅗㅈㅜㅇ	길을 가는 중간.
도착	ㄷㅗㅊㅏㄱ	목적지에 다다름.
도청	ㄷㅗㅊㅓㅇ	남이 하는 이야기, 전화 통화 내용 등을 몰래 엿듣거나 녹음하는 일.
도체	ㄷㅗㅊㅓㅣ	열이나 전기 등이 잘 통하는 물체.
도출	ㄷㅗㅊㅜㄹ	어떤 일에 대한 생각, 결론, 판단 등을 이끌어 냄.
도취	ㄷㅗㅊㅜㅣ	술을 마시고 적당히 기분이 좋게 취함.
도탄	ㄷㅗㅌㅏㄴ	몹시 어렵고 고통스러운 상황이나 생활.
도태	ㄷㅗㅌㅏㅣ	여럿 가운데에서 필요 없거나 적당하지 않다고 여겨지는 것들을 없앰.
도합	ㄷㅗㅎㅏㅂ	모두 합한 셈.
도해	ㄷㅗㅎㅏㅣ	글의 내용을 그림으로 풀이한 설명. 또는 그렇게 한 그림.
도형	ㄷㅗㅎㅕㅇ	그림의 모양이나 형태.
도회	ㄷㅗㅎㅗㅣ	사람이 많이 살고 상공업이 발달한 번화한 지역.
독기	ㄷㅗㄱㄱㅣ	독의 기운.
독도	ㄷㅗㄱㄷㅗ	울릉도 남동쪽에 있는 화산섬. 한국에서 가장 동쪽에 있는 섬으로 거의 암석으로 이루어져 있으며 주변 바다에는 수산 자원이 풍부하다.
독려	ㄷㅗㄱㄹㅕ	일이 잘못되지 않도록 살피며 격려함.
독사	ㄷㅗㄱㅅㅏ	이빨에 독이 있는 뱀.
독서	ㄷㅗㄱㅅㅓ	책을 읽음.
독소	ㄷㅗㄱㅅㅗ	독성이 있는 요소나 물질.
독어	ㄷㅗㄱㅇㅓ	주로 독일과 오스트리아 사람들이 쓰는 언어.
독자	ㄷㅗㄱㅈㅏ	다른 자식이 없이 단 하나뿐인 아들.
독주	ㄷㅗㄱㅈㅜ	매우 독한 술.
독지	ㄷㅗㄱㅈㅣ	남을 돕고 위하는 마음.
독초	ㄷㅗㄱㅊㅗ	독이 들어 있는 풀.
돌기	ㄷㅗㄹㄱㅣ	피부나 사물의 표면에 볼록하게 튀어나온 부분.
돌파	ㄷㅗㄹㅍㅏ	적진이나 상대의 수비를 뚫고 들어감.
동거	ㄷㅗㅇㄱㅓ	같은 집이나 같은 방에서 함께 삶.
동기	ㄷㅗㅇㄱㅣ	형제와 자매, 남매.
동료	ㄷㅗㅇㄹㅛ	직장에서 함께 일하는 사람.
동류	ㄷㅗㅇㄹㅠ	같은 종류나 부류.
동리	ㄷㅗㅇㄹㅣ	시골의 마을이나 동네.
동무	ㄷㅗㅇㅁㅜ	친하게 어울리는 사람.
동부	ㄷㅗㅇㅂㅜ	어떤 지역의 동쪽 부분.
동사	ㄷㅗㅇㅅㅏ	추위에 얼어 죽음.
동서	ㄷㅗㅇㅅㅓ	남편의 형의 아내.
동시	ㄷㅗㅇㅅㅣ	같은 때.
동요	ㄷㅗㅇㅇㅛ	물체가 이리저리 흔들림.
동이	ㄷㅗㅇㅇㅣ	물 긷는 데 쓰며 모양이 둥글고 입구가 넓고 양 옆에 손잡이가 달린 질그릇.
동조	ㄷㅗㅇㅈㅗ	다른 사람의 말이나 생각, 주장 등을 옳게 여겨 따름.
동지	ㄷㅗㅇㅈㅣ	일 년 중 밤이 가장 긴 날로 이십사절기의 하나. 12월 22일경이다. 귀신을 쫓기 위해 붉은 팥으로 죽을 쑤어 먹고 문이나 벽에 팥죽을 조금씩 뿌리는 풍습이 있다.
동토	ㄷㅗㅇㅌㅗ	얼어붙은 땅.
동파	ㄷㅗㅇㅍㅏ	얼어서 터짐.
동포	ㄷㅗㅇㅍㅗ	같은 나라나 민족에 속하는 사람.
두각	ㄷㅜㄱㅏㄱ	뛰어난 재주나 기술, 지식.
두건	ㄷㅜㄱㅓㄴ	헝겊이나 천 등으로 만든 머리에 쓰는 물건.
두뇌	ㄷㅜㄴㅗㅣ	사람이나 동물의 신경을 다스리는 머릿속에 있는 기관.
두둑	ㄷㅜㄷㅜㄱ	두 논이나 밭 사이의 경계를 이루는 작은 둑이나 언덕.
두둔	ㄷㅜㄷㅜㄴ	편들어 주거나 잘못을 감싸 줌.
두렁	ㄷㅜㄹㅓㅇ	두 논이나 밭 사이의 경계를 이루는 낮은 둑이나 언덕.
두레	ㄷㅜㄹㅓㅣ	농촌에서 농사일이 바쁠 때에 서로 도와서 공동으로 일을 하기 위해 만든 조직.
두령	ㄷㅜㄹㅕㅇ	주로 도둑의 무리와 같은 불법적인 단체의 우두머리.
두름	ㄷㅜㄹㅡㅁ	생선 스무 마리를 열 마리씩 두 줄로 묶어 놓은 것.
두말	ㄷㅜㅁㅏㄹ	처음에 했던 말과는 다른 내용의 말.
두메	ㄷㅜㅁㅓㅣ	도시에서 멀리 떨어져 개발이 되지 않고 사람이 많이 살지 않는 산골.
두목	ㄷㅜㅁㅗㄱ	도둑의 무리와 같이 좋지 못한 무리의 우두머리.
두발	ㄷㅜㅂㅏㄹ	머리에 난 털.
두상	ㄷㅜㅅㅏㅇ	머리 모양.
두엄	ㄷㅜㅇㅓㅁ	풀, 짚 또는 가축의 똥과 오줌 등을 썩힌 거름.
두절	ㄷㅜㅈㅓㄹ	교통이나 통신 등의 연결이 막히거나 끊어짐.
두통	ㄷㅜㅌㅗㅇ	머리가 아픈 증세.
둔부	ㄷㅜㄴㅂㅜ	뒤쪽 허리 아래에서 양쪽 허벅지로 이어지는, 둥글고 살이 많은 부분.
둔치	ㄷㅜㄴㅊㅣ	물가 또는 물가의 언덕.
둥지	ㄷㅜㅇㅈㅣ	새가 알을 낳거나 살기 위해 풀, 나뭇가지 등을 엮어 만든 둥근 모양의 집.
둥치	ㄷㅜㅇㅊㅣ	큰 나무의 줄기와 뿌리가 만나는 부분.
뒤주	ㄷㅜㅣㅈㅜ	쌀, 보리, 콩 등의 곡식을 담아 두는 데 쓰는 네모나고 큰 나무 상자.
드럼	ㄷㅡㄹㅓㅁ	기름 등을 담을 때 쓰는 두꺼운 철판으로 만든 원기둥 모양의 통.
드릴	ㄷㅡㄹㅣㄹ	나무나 금속에 구멍을 뚫는 도구.
득도	ㄷㅡㄱㄷㅗ	진리나 도를 깨달음.
득표	ㄷㅡㄱㅍㅛ	투표에서 찬성표를 얻음. 또는 얻은 찬성표.
듣기	ㄷㅡㄷㄱㅣ	남의 말을 올바르게 알아듣고 이해하는 일.
들소	ㄷㅡㄹㅅㅗ	산이나 들에서 나서 자란 소.
등가	ㄷㅡㅇㄱㅏ	비교 대상이 되는 두 개의 사물 또는 일의 값이나 가치가 같음. 또는 그런 값이나 가치.
등교	ㄷㅡㅇㄱㅛ	학생이 학교에 감.
등기	ㄷㅡㅇㄱㅣ	땅이나 집 같은 부동산에 대한 권리 관계를 법정 절차에 따라 등기부에 기록하는 일. 또는 그런 기록.
등수	ㄷㅡㅇㅅㅜ	등급에 따라 정한 차례를 나타내는 숫자.
등유	ㄷㅡㅇㅇㅠ	등불을 켜거나 난로를 피우는 데 쓰는, 원유를 증류하여 얻는 기름.
등호	ㄷㅡㅇㅎㅗ	수학에서, 두 식 또는 두 수가 같음을 나타내는 부호.
디귿	ㄷㅣㄱㅡㄷ	한글 자모 ‘ㄷ’의 이름.
딜러	ㄷㅣㄹㄹㅓ	유통 단계에서 상품을 한 번에 많이 사들이고 다시 파는 일을 하는 사람.
땜	ㄷㄷㅏㅣㅁ	구멍이나 틈이 생긴 곳을 다른 것으로 대어 막음.
땡	ㄷㄷㅏㅣㅇ	화투에서, 같은 짝 두 장으로 이루어진 패.
라면	ㄹㅏㅁㅕㄴ	기름에 튀겨 말린 국수와 가루 스프가 들어 있어서 물에 끓이기만 하면 간편하게 먹을 수 있는 음식.
라인	ㄹㅏㅇㅣㄴ	가로나 세로로 그은 금이나 줄. 또는 어떤 물건의 윤곽.
럭비	ㄹㅓㄱㅂㅣ	15명이 한 팀이 되어 길쭉한 공을 손에 들거나 발로 차면서 상대편의 골에 넣어 점수를 얻는 경기.
레저	ㄹㅓㅣㅈㅓ	일이나 공부를 하지 않아도 되는 자유롭고 한가한 때. 또는 그 시간을 이용하여 편안하게 노는 일.
로봇	ㄹㅗㅂㅗㅅ	사람의 전체 모습이나 몸의 한 부위와 비슷하게 만들어서 사람이 하는 행동이나 작업 등을 할 수 있도록 만든 기계.
로션	ㄹㅗㅅㅕㄴ	피부를 부드럽고 촉촉하게 하기 위해 바르는, 걸쭉한 액체 상태의 화장품.
롤러	ㄹㅗㄹㄹㅓ	금속재의 두께를 줄이거나 평평하게 하는 데 쓰는 원통형 기구.
리듬	ㄹㅣㄷㅡㅁ	소리의 높낮이, 길이, 세기 등이 일정하게 반복되는 것.
리본	ㄹㅣㅂㅗㄴ	머리, 모자, 선물 등을 장식할 때 쓰는 끈이나 띠.
리을	ㄹㅣㅇㅡㄹ	한글 자모 ‘ㄹ’의 이름.
리콜	ㄹㅣㅋㅗㄹ	어떤 상품에 결함이 있을 때 생산 업체에서 그 상품을 회수하여 점검이나 수리, 또는 교환을 해 주는 제도.
린스	ㄹㅣㄴㅅㅡ	샴푸로 머리를 감고 나서 헹굴 때 머릿결을 부드럽게 하고 윤기를 내기 위해 쓰는 세제. 또는 그것으로 머리를 헹구는 일.
린치	ㄹㅣㄴㅊㅣ	정당한 법적 절차 없이 폭력을 가하는 것.
림프	ㄹㅣㅁㅍㅡ	동물의 조직 세포 사이를 채우고 있으며 면역과 관련된 기능을 하는 무색의 액체.
링거	ㄹㅣㅇㄱㅓ	생리적인 기능을 유지할 수 있도록 몸속에 체액 대신 넣는 액체.
링크	ㄹㅣㅇㅋㅡ	인터넷에서 지정한 파일이나 페이지로 이동할 수 있도록 홈페이지를 서로 연결하는 것.
마감	ㅁㅏㄱㅏㅁ	어떤 일을 끝냄.
마개	ㅁㅏㄱㅏㅣ	병 등의 입구나 구멍을 막는 물건.
마귀	ㅁㅏㄱㅜㅣ	못된 귀신.
마늘	ㅁㅏㄴㅡㄹ	통통한 작은 덩이 여러 쪽이 둥근 모양을 이루고 있고, 독특한 냄새가 있어 양념과 반찬에 널리 쓰이는 채소.
마님	ㅁㅏㄴㅣㅁ	(높이는 말로) 신분이나 지위가 높은 집안의 부인.
마담	ㅁㅏㄷㅏㅁ	술집, 다방 등의 여자 주인.
마당	ㅁㅏㄷㅏㅇ	집에 딸려 있는 평평하고 비어 있는 땅.
마대	ㅁㅏㄷㅏㅣ	굵고 거친 삼실로 짠 큰 자루.
마력	ㅁㅏㄹㅕㄱ	사람의 마음을 끄는 이상한 힘.
마련	ㅁㅏㄹㅕㄴ	어떤 물건이나 상황을 준비하여 갖춤.
마름	ㅁㅏㄹㅡㅁ	(옛날에) 땅 주인을 대신하여 농지를 관리하는 사람.
마멸	ㅁㅏㅁㅕㄹ	마찰로 인해서 조금씩 닳아 없어짐.
마법	ㅁㅏㅂㅓㅂ	초자연적인 능력으로 과학적으로 설명할 수 없는 신기한 일을 하는 기술.
마술	ㅁㅏㅅㅜㄹ	빠른 손놀림이나 장치 등을 사용하여 사람의 눈을 교묘하게 속여 사람들을 즐겁게 해 주는 기술.
마약	ㅁㅏㅇㅑㄱ	먹거나 주사를 맞으면 마취나 환각을 일으켜 자주 쓰면 중독이 되는 약물.
마을	ㅁㅏㅇㅡㄹ	여러 집이 모여 있는 곳.
마음	ㅁㅏㅇㅡㅁ	사람이 태어날 때부터 지닌 성질.
마작	ㅁㅏㅈㅏㄱ	네 사람이 글씨나 숫자가 새겨진 136개의 패를 가지고 짝을 맞추어 승부를 겨루는 놀이.
마적	ㅁㅏㅈㅓㄱ	(옛날에) 말을 타고 떼지어 다니며 사람을 해치거나 재물을 빼앗는 도둑.
마중	ㅁㅏㅈㅜㅇ	역이나 공항 등에 나가서 자기를 찾아오는 사람을 맞이함.
마진	ㅁㅏㅈㅣㄴ	원가와 판매하는 가격 사이의 차액.
마찰	ㅁㅏㅊㅏㄹ	두 물체가 서로 닿아 문질러지거나 비벼짐. 또는 그렇게 함.
마취	ㅁㅏㅊㅜㅣ	약물을 사용해서 일정 시간 동안 의식이나 감각을 잃게 함.
마패	ㅁㅏㅍㅏㅣ	조선 시대에 관리가 나라의 말을 이용할 때 증표로 쓰던 둥근 패.
막료	ㅁㅏㄱㄹㅛ	조직 내에서 계획을 세우고 자문과 조언을 하며 최고 책임자를 보좌하는 사람.
막사	ㅁㅏㄱㅅㅏ	천이나 나무 등을 이용해 임시로 간단하게 지은 집.
막차	ㅁㅏㄱㅊㅏ	그날 마지막으로 운행되는 차.
막후	ㅁㅏㄱㅎㅜ	겉으로 드러나지 않고 감추어진 뒷면.
만가	ㅁㅏㄴㄱㅏ	사람의 죽음을 슬퍼하며 부르는 노래.
만고	ㅁㅏㄴㄱㅗ	아주 오랜 세월.
만기	ㅁㅏㄴㄱㅣ	정해 놓은 기한이 다 됨. 또는 그 기한.
만두	ㅁㅏㄴㄷㅜ	밀가루를 반죽하여 얇게 민 후 그 위에 다진 고기나 야채 등 여러 가지 음식을 넣고 빚은 음식.
만료	ㅁㅏㄴㄹㅛ	정해진 기한이 다 차서 끝남.
만루	ㅁㅏㄴㄹㅜ	야구에서, 일루, 이루, 삼루에 모두 주자가 있는 상태.
만류	ㅁㅏㄴㄹㅠ	어떤 일을 하지 못하게 붙잡고 말림.
만무	ㅁㅏㄴㅁㅜ	어떤 일이 일어날 가능성이 전혀 없음.
만사	ㅁㅏㄴㅅㅏ	여러 가지 온갖 일.
만수	ㅁㅏㄴㅅㅜ	오래 삶.
만유	ㅁㅏㄴㅇㅠ	우주에 있는 모든 것.
만조	ㅁㅏㄴㅈㅗ	밀물이 들어와 바다의 수면이 가장 높은 곳까지 올라오는 현상. 또는 그런 때.
만주	ㅁㅏㄴㅈㅜ	중국 북동부의 둥베이 지방. 일제 시대에 수많은 조선인들이 이주해 간 지역으로 우리 동포가 많이 살고 있다.
만추	ㅁㅏㄴㅊㅜ	늦은 가을.
맏이	ㅁㅏㄷㅇㅣ	여러 형제자매 가운데 첫 번째로 태어난 사람.
말기	ㅁㅏㄹㄱㅣ	어떤 기간의 끝이 되는 시기.
말로	ㅁㅏㄹㄹㅗ	인생의 마지막 무렵.
말미	ㅁㅏㄹㅁㅣ	일정한 직업이나 일 등에 매인 사람이 다른 일을 하기 위해 얻는 시간적 여유.
말보	ㅁㅏㄹㅂㅗ	평소에는 조용하던 사람의 입에서 막힘없이 터져 나오는 말.
말소	ㅁㅏㄹㅅㅗ	기록되어 있는 사실 등을 지워 없애 버림.
말수	ㅁㅏㄹㅅㅜ	사람이 하는 말의 수.
말초	ㅁㅏㄹㅊㅗ	사물의 맨 끝부분.
말투	ㅁㅏㄹㅌㅜ	말을 하는 버릇이나 형식.
맘마	ㅁㅏㅁㅁㅏ	(어린아이의 말로) 밥.
맘보	ㅁㅏㅁㅂㅗ	마음을 쓰는 모양.
망고	ㅁㅏㅇㄱㅗ	타원형에 과육이 노랗고 부드러우며 단맛이 나는 열대 과일.
망루	ㅁㅏㅇㄹㅜ	주위를 살필 수 있도록 높은 기둥 위에 벽이 없는 마루를 놓은 곳.
망사	ㅁㅏㅇㅅㅏ	촘촘하지 않게 그물처럼 짠 천.
망자	ㅁㅏㅇㅈㅏ	죽은 사람.
망조	ㅁㅏㅇㅈㅗ	망할 징조.
망치	ㅁㅏㅇㅊㅣ	쇠뭉치에 손잡이를 달아 단단한 물건을 두드리거나 못을 박는 데 쓰는 연장.
망토	ㅁㅏㅇㅌㅗ	소매가 없이 어깨 위로 걸쳐 둘러 입도록 만든 외투.
맞수	ㅁㅏㅈㅅㅜ	힘, 재주, 기량 등이 서로 비슷하여 우열을 가리기 어려운 상대.
매기	ㅁㅏㅣㄱㅣ	일정하게 구분하여 정한 하나하나의 시기.
매너	ㅁㅏㅣㄴㅓ	일상생활에서 갖추는 예의나 자세 또는 행동 방식.
매도	ㅁㅏㅣㄷㅗ	다른 사람을 심하게 비난하며 몰아세움.
매미	ㅁㅏㅣㅁㅣ	1.2~8 센티미터 정도의 몸에 투명한 날개가 있고 수컷이 나무에 붙어 시끄럽게 우는 여름 곤충.
매부	ㅁㅏㅣㅂㅜ	남자가 여자 형제의 남편을 이르거나 부르는 말.
매사	ㅁㅏㅣㅅㅏ	하나하나의 모든 일.
매수	ㅁㅏㅣㅅㅜ	종이나 유리 등의 장으로 셀 수 있는 물건의 수.
매주	ㅁㅏㅣㅈㅜ	각각의 주.
매초	ㅁㅏㅣㅊㅗ	일 초 일 초.
매치	ㅁㅏㅣㅊㅣ	서로 조화를 이루어 잘 어울림.
매트	ㅁㅏㅣㅌㅡ	스프링과 스펀지 등을 넣어 두툼하고 푹신하게 만든 침대용 요.
매표	ㅁㅏㅣㅍㅛ	차표나 입장권 등의 표를 삼.
머슴	ㅁㅓㅅㅡㅁ	농가에서 고용되어 그 집의 농사일과 집안일을 봐주는 일을 하던 남자.
머핀	ㅁㅓㅍㅣㄴ	밀가루에 설탕, 유지, 우유, 달걀, 베이킹파우더 따위를 넣고 틀을 사용하여 오븐에 구워 낸 빵.
먹보	ㅁㅓㄱㅂㅗ	(놀리는 말로) 미련스럽게 음식을 많이 먹거나 음식에 대한 욕심이 많은 사람.
먹이	ㅁㅓㄱㅇㅣ	동물이 살기 위해 먹어야 하는 것. 또는 기르는 가축에게 주는 먹을거리.
먹지	ㅁㅓㄱㅈㅣ	아래위로 종이를 대고 눌러 써서 복사를 하도록 만든 검은 칠을 묻힌 종이.
먼저	ㅁㅓㄴㅈㅓ	시간이나 순서에서 앞선 때.
먼지	ㅁㅓㄴㅈㅣ	공중에 흩날리거나 물건 위에 쌓이는 아주 작고 가벼운 물질.
멀리	ㅁㅓㄹㄹㅣ	먼 곳.
멀미	ㅁㅓㄹㅁㅣ	자동차, 배, 비행기 등을 탈 때, 그 흔들림 때문에 생기는 어지럽고 메스꺼운 증세.
메뉴	ㅁㅓㅣㄴㅠ	음식점에서 파는 음식의 종류와 가격을 적은 판.
메모	ㅁㅓㅣㅁㅗ	잊지 않거나 다른 사람에게 전하기 위해 어떤 내용을 간단하게 글로 적음. 또는 그렇게 적은 글.
메스	ㅁㅓㅣㅅㅡ	수술이나 해부를 하는 데 쓰는 칼.
메주	ㅁㅓㅣㅈㅜ	장을 담그기 위해 삶은 콩을 찧어 크고 네모난 덩이로 뭉쳐서 발효시켜 말린 것.
며칠	ㅁㅕㅊㅣㄹ	그달의 몇째 날.
면도	ㅁㅕㄴㄷㅗ	얼굴이나 몸에 난 수염이나 잔털을 깎음.
면모	ㅁㅕㄴㅁㅗ	사람이나 사물의 겉모습.
면허	ㅁㅕㄴㅎㅓ	특정 기술에 대해 국가에서 인정하는 자격.
멸시	ㅁㅕㄹㅅㅣ	다른 사람을 얕보거나 하찮게 여겨 무시함.
멸치	ㅁㅕㄹㅊㅣ	몸은 13 센티미터 정도에 등은 검푸르고 배는 은백색이며 주로 말리거나 젓을 담가 먹는 바닷물고기.
명가	ㅁㅕㅇㄱㅏ	명성이 있는 가문이나 집안.
명구	ㅁㅕㅇㄱㅜ	뛰어나게 잘 쓴 글귀.
명기	ㅁㅕㅇㄱㅣ	분명하게 밝혀서 적음.
명도	ㅁㅕㅇㄷㅗ	색의 밝고 어두운 정도.
명리	ㅁㅕㅇㄹㅣ	명예와 이익.
명부	ㅁㅕㅇㅂㅜ	어떤 일에 관련되거나 조직에 속한 사람의 이름이나 주소, 연락처 등을 적어 놓은 장부.
명사	ㅁㅕㅇㅅㅏ	훌륭한 인품이나 학식이 있거나 사회적으로 성공하여 유명해진 사람.
명소	ㅁㅕㅇㅅㅗ	아름다운 경치나 유적, 특산물 등으로 유명한 장소.
명수	ㅁㅕㅇㅅㅜ	어떤 기능이나 기술 등에서 뛰어난 능력을 가진 사람.
명시	ㅁㅕㅇㅅㅣ	이름난 시. 또는 아주 잘 지은 시.
명저	ㅁㅕㅇㅈㅓ	내용이 훌륭하여 이름난 책.
명주	ㅁㅕㅇㅈㅜ	명주실로 무늬 없이 짠 천.
명차	ㅁㅕㅇㅊㅏ	품질이 좋아 이름난 자동차.
명치	ㅁㅕㅇㅊㅣ	급소의 하나로, 가슴뼈 아래 한가운데의 오목하게 들어간 곳.
모계	ㅁㅗㄱㅕㅣ	혈연 관계에서 어머니 쪽의 계통.
모골	ㅁㅗㄱㅗㄹ	털과 뼈.
모공	ㅁㅗㄱㅗㅇ	털이 나는 작은 구멍.
모과	ㅁㅗㄱㅗㅏ	향기가 좋아 설탕에 절여 먹거나 차를 달여 먹거나 한약의 재료로 쓰는 타원형의 노란 열매.
모국	ㅁㅗㄱㅜㄱ	자기가 태어난 나라.
모금	ㅁㅗㄱㅡㅁ	기부금이나 성금 등을 모음.
모독	ㅁㅗㄷㅗㄱ	말이나 행동으로 어떤 대상을 부끄럽고 수치스럽게 만듦.
모둠	ㅁㅗㄷㅜㅁ	초, 중등학교에서, 효율적인 학습을 위하여 학생들을 대여섯 명 내외로 묶은 모임.
모듬	ㅁㅗㄷㅡㅁ	→ 모임
모래	ㅁㅗㄹㅏㅣ	자연의 힘으로 잘게 부스러진 돌의 알갱이.
모략	ㅁㅗㄹㅑㄱ	남을 해치려고 속임수를 쓰거나 거짓으로 꾸밈.
모레	ㅁㅗㄹㅓㅣ	내일의 다음 날.
모면	ㅁㅗㅁㅕㄴ	꾀를 써서 또는 운 좋게 어려운 상황이나 책임 등에서 벗어남.
모멸	ㅁㅗㅁㅕㄹ	업신여기고 깔봄.
모반	ㅁㅗㅂㅏㄴ	배반을 꾀함.
모발	ㅁㅗㅂㅏㄹ	사람의 머리카락.
모방	ㅁㅗㅂㅏㅇ	다른 것을 본뜨거나 남의 행동을 흉내 냄.
모범	ㅁㅗㅂㅓㅁ	본받아 배울 만한 행동이나 그러한 행동을 하는 사람.
모빌	ㅁㅗㅂㅣㄹ	가느다란 철사나 실 등에 여러 가지 모양의 나뭇조각이나 금속 조각 등을 매달아 균형을 이루게 한 공예품.
모성	ㅁㅗㅅㅓㅇ	여성이 어머니로서 지니는 본능적인 성질.
모션	ㅁㅗㅅㅕㄴ	어떤 움직임이나 몸짓.
모순	ㅁㅗㅅㅜㄴ	어떤 사실의 앞뒤, 또는 두 사실이 서로 어긋나 이치에 맞지 않음.
모습	ㅁㅗㅅㅡㅂ	사람이나 사물의 생김새.
모양	ㅁㅗㅇㅑㅇ	겉으로 나타나는 생김새나 모습.
모욕	ㅁㅗㅇㅛㄱ	낮추어 보고 창피를 주고 불명예스럽게 함.
모음	ㅁㅗㅇㅡㅁ	사람이 목청을 울려 내는 소리로, 공기의 흐름이 방해를 받지 않고 나는 소리.
모의	ㅁㅗㅇㅡㅣ	실제와 똑같이 따라 해 봄. 또는 그런 일.
모임	ㅁㅗㅇㅣㅁ	어떤 일을 하기 위하여 여러 사람이 모이는 일.
모정	ㅁㅗㅈㅓㅇ	자식에 대한 어머니의 정.
모종	ㅁㅗㅈㅗㅇ	옮겨 심으려고 씨앗을 뿌려 가꾼 벼 이외의 어린 식물. 또는 그것을 옮겨 심음.
모직	ㅁㅗㅈㅣㄱ	털실로 짠 천.
모집	ㅁㅗㅈㅣㅂ	사람이나 작품, 물건 등을 일정한 조건에 맞게 널리 알려 뽑거나 모음.
모체	ㅁㅗㅊㅓㅣ	아이나 새끼를 밴 어미의 몸.
모친	ㅁㅗㅊㅣㄴ	자기 혹은 다른 사람의 어머니를 정중하게 이르는 말.
모태	ㅁㅗㅌㅏㅣ	아기나 새끼가 있는 어미의 배 속.
모함	ㅁㅗㅎㅏㅁ	나쁜 꾀를 부려 아무 잘못 없는 사람을 어려운 처지에 빠뜨림.
모험	ㅁㅗㅎㅓㅁ	힘들거나 위험할 줄 알면서도 어떤 일을 함.
모형	ㅁㅗㅎㅕㅇ	모양이 같은 물건을 만들거나 찍어 내는 틀.
목기	ㅁㅗㄱㄱㅣ	나무로 만든 그릇.
목마	ㅁㅗㄱㅁㅏ	주로 어린이의 오락이나 말 타는 연습 등에 쓰며 나무를 깎아 말의 모양으로 만든 물건.
목사	ㅁㅗㄱㅅㅏ	일정한 자격을 갖추고 교회를 관리하면서 예배를 이끌고 신자들에게 영적 생활을 지도하는 성직자.
목수	ㅁㅗㄱㅅㅜ	나무로 집을 짓거나 가구 등의 물건을 만드는 사람.
목자	ㅁㅗㄱㅈㅏ	양을 먹이고 돌보는 사람.
목조	ㅁㅗㄱㅈㅗ	나무에 어떤 모양을 새기거나 나무를 깎아서 물건을 만드는 일. 또는 그렇게 만든 작품.
목차	ㅁㅗㄱㅊㅏ	글이나 책 등에서 여러 제목이나 항목을 순서대로 늘어놓은 목록.
목초	ㅁㅗㄱㅊㅗ	나무와 풀.
목표	ㅁㅗㄱㅍㅛ	어떤 목적을 이루기 위하여 도달해야 할 구체적인 대상.
목하	ㅁㅗㄱㅎㅏ	지금 이 순간.
몰두	ㅁㅗㄹㄷㅜ	다른 일에 관심을 가지지 않고 한 가지 일에만 집중함.
몰수	ㅁㅗㄹㅅㅜ	죄를 지은 사람에게서 범죄 행위에 제공하거나 범죄 행위의 결과로 얻은 재산을 강제로 빼앗는 일.
몰아	ㅁㅗㄹㅇㅏ	자기 자신을 잊을 만큼 어떤 일에 완전히 집중한 상태.
몰표	ㅁㅗㄹㅍㅛ	투표로 여러 사람 중 한 사람을 뽑을 때 한 명의 후보자에게 몰린 표.
몽고	ㅁㅗㅇㄱㅗ	중앙아시아 내륙에 있는 나라. ‘몽골’을 한국식 한자음으로 읽은 이름이다.
묘령	ㅁㅛㄹㅕㅇ	스무 살 안팎의 여자 나이.
묘목	ㅁㅛㅁㅗㄱ	다른 곳으로 옮겨 심기 위하여 키우는 어린 나무.
묘법	ㅁㅛㅂㅓㅂ	문제를 해결할 수 있는 교묘하고 좋은 방법.
묘안	ㅁㅛㅇㅏㄴ	문제를 해결할 수 있는 뛰어나게 좋은 생각.
묘약	ㅁㅛㅇㅑㄱ	어떤 병을 치료하는 데 효과가 매우 좋은 약.
묘역	ㅁㅛㅇㅕㄱ	묘소 경계 안의 구역.
묘판	ㅁㅛㅍㅏㄴ	논에 모내기를 하기 전에 미리 볍씨를 뿌려서 모를 기르는 판.
무게	ㅁㅜㄱㅓㅣ	물건의 무거운 정도.
무공	ㅁㅜㄱㅗㅇ	전쟁 등 군사와 관련된 일에서 세운 공적.
무궁	ㅁㅜㄱㅜㅇ	끝이 없음.
무극	ㅁㅜㄱㅡㄱ	끝이나 한계가 없음.
무급	ㅁㅜㄱㅡㅂ	일에 대한 대가를 받지 않음.
무념	ㅁㅜㄴㅕㅁ	감정이나 생각이 없음.
무논	ㅁㅜㄴㅗㄴ	물이 모여 있는 논.
무능	ㅁㅜㄴㅡㅇ	어떤 일을 할 능력이나 재주가 없음.
무늬	ㅁㅜㄴㅡㅣ	물건의 겉면에 나타난 모양.
무단	ㅁㅜㄷㅏㄴ	무력 등을 사용하여 강제로 행함.
무당	ㅁㅜㄷㅏㅇ	귀신을 받들어 점치고 굿을 하는 것을 직업으로 하는 사람.
무대	ㅁㅜㄷㅏㅣ	연극, 무용, 음악 등을 공연하기 위하여 객석 앞에 좀 높게 만들어 놓은 넓은 자리.
무덤	ㅁㅜㄷㅓㅁ	죽은 사람의 몸이나 유골을 땅에 묻어 놓은 곳.
무력	ㅁㅜㄹㅕㄱ	군사적인 힘.
무례	ㅁㅜㄹㅕㅣ	말이나 행동에 예의가 없음.
무릎	ㅁㅜㄹㅡㅍ	허벅지와 종아리 사이에 앞쪽으로 둥글게 튀어나온 부분.
무명	ㅁㅜㅁㅕㅇ	목화솜으로 만든 실로 짠 천.
무법	ㅁㅜㅂㅓㅂ	법이나 제도가 바로 서지 않아 무질서함.
무병	ㅁㅜㅂㅕㅇ	병이 없이 건강함.
무상	ㅁㅜㅅㅏㅇ	시간이 가면서 모든 것이 변하므로 가치나 의미가 없어 허무함.
무선	ㅁㅜㅅㅓㄴ	전선을 연결하지 않고 전파를 통해 통신이나 방송을 보내거나 받음.
무성	ㅁㅜㅅㅓㅇ	소리가 없거나 소리를 내지 않음.
무속	ㅁㅜㅅㅗㄱ	귀신을 섬겨 점을 보거나 굿을 하여 재앙을 물리치고 복을 비는 풍속.
무쇠	ㅁㅜㅅㅗㅣ	탄소 등 여러 물질이 포함되어 있으며 단단하나 쉽게 부러지고 녹이 잘 스는 합금의 하나.
무술	ㅁㅜㅅㅜㄹ	몸을 움직이거나 무기를 사용하여 상대를 공격하거나 상대의 공격을 막는 기술.
무식	ㅁㅜㅅㅣㄱ	배우거나 보고 들은 것이 없어 아는 것이 부족함.
무신	ㅁㅜㅅㅣㄴ	(옛날에) 신하 가운데 무관인 사람.
무심	ㅁㅜㅅㅣㅁ	아무런 생각이나 감정이 없음.
무안	ㅁㅜㅇㅏㄴ	얼굴을 들지 못할 만큼 수줍거나 창피함.
무언	ㅁㅜㅇㅓㄴ	말이 없음.
무역	ㅁㅜㅇㅕㄱ	지방과 지방 사이에 서로 물건을 사고파는 일.
무예	ㅁㅜㅇㅕㅣ	무술에 관한 재주.
무욕	ㅁㅜㅇㅛㄱ	욕심이 없음.
무용	ㅁㅜㅇㅛㅇ	무예가 뛰어나고 용감함.
무위	ㅁㅜㅇㅜㅣ	이룬 것이 없음.
무인	ㅁㅜㅇㅣㄴ	사람이 없음.
무임	ㅁㅜㅇㅣㅁ	돈을 내지 않음.
무장	ㅁㅜㅈㅏㅇ	전쟁이나 전투를 하기 위한 장비 등을 갖춤. 또는 그 장비.
무적	ㅁㅜㅈㅓㄱ	매우 강하여 맞서 겨룰 만한 상대가 없음. 또는 그런 사람.
무전	ㅁㅜㅈㅓㄴ	전선을 사용하지 않고 전파를 이용하는 통신.
무정	ㅁㅜㅈㅓㅇ	사랑하거나 좋아하는 마음이 없어 차갑고 인정이 없음.
무제	ㅁㅜㅈㅓㅣ	글이나 노래, 그림 등의 제목이 없음. 또는 일정한 제목이 없다는 뜻으로 붙인 제목.
무좀	ㅁㅜㅈㅗㅁ	발가락 사이나 발바닥이 균에 감염되어 물집이 생기거나 살 껍질이 갈라지거나 벗겨져서 몹시 가려운 피부병.
무죄	ㅁㅜㅈㅗㅣ	아무런 잘못이나 죄가 없음.
무직	ㅁㅜㅈㅣㄱ	직업이 없거나 일정한 직업을 가지지 못함.
무취	ㅁㅜㅊㅜㅣ	냄새가 없거나 냄새가 나지 않음.
무침	ㅁㅜㅊㅣㅁ	나물이나 채소, 말린 생선, 회 등에 양념을 하여 무친 반찬.
무패	ㅁㅜㅍㅏㅣ	싸움이나 경기에서 한 번도 진 적이 없음.
무풍	ㅁㅜㅍㅜㅇ	바람이 없음. 또는 그러한 상태.
무학	ㅁㅜㅎㅏㄱ	학교를 다닌 적이 없음. 또는 배우지 못함.
무한	ㅁㅜㅎㅏㄴ	수나 양, 크기, 공간이나 시간의 끝이나 제한이 없음.
무혈	ㅁㅜㅎㅕㄹ	피를 흘리지 않는다는 뜻으로 사람이 다치거나 죽는 것이 없음.
무협	ㅁㅜㅎㅕㅂ	의리가 있고 정의로운, 무술 실력 뛰어난 사람의 이야기를 다룬 것.
무형	ㅁㅜㅎㅕㅇ	구체적인 모양이나 모습이 없음. 또는 정해진 형식이 없음.
무희	ㅁㅜㅎㅡㅣ	춤추는 일이 직업인 여자.
묵도	ㅁㅜㄱㄷㅗ	눈을 감고 조용히 마음속으로 비는 기도.
묵시	ㅁㅜㄱㅅㅣ	말이나 행동으로 직접 드러내지 않고 남이 모르는 사이에 뜻을 나타내 보임.
묵주	ㅁㅜㄱㅈㅜ	가톨릭에서, 기도할 때 사용하는 줄에 꿴 구슬.
문가	ㅁㅜㄴㄱㅏ	문의 옆이나 주변.
문고	ㅁㅜㄴㄱㅗ	책을 읽을 수 있도록 모아서 보관하는 곳.
문구	ㅁㅜㄴㄱㅜ	특정한 뜻을 나타내는, 몇 낱말로 된 말.
문리	ㅁㅜㄴㄹㅣ	글의 뜻을 깨달아 아는 힘.
문무	ㅁㅜㄴㅁㅜ	문관과 무관.
문사	ㅁㅜㄴㅅㅏ	학문을 하는 선비.
문서	ㅁㅜㄴㅅㅓ	다른 일의 자료가 되거나 어떤 사실을 증명하는 데 쓰이는 글을 적은 종이.
문어	ㅁㅜㄴㅇㅓ	붉은 갈색의 둥근 몸통에 빨판이 달린 여덟 개의 발이 아래에 붙어 있는 연체동물.
문우	ㅁㅜㄴㅇㅜ	글을 통해 사귀게 된 친구.
문자	ㅁㅜㄴㅈㅏ	언어의 소리나 뜻을 눈으로 볼 수 있도록 적은 기호 체계.
문초	ㅁㅜㄴㅊㅗ	잘못이 있는 사람에게 죄, 잘못 등을 따져 묻거나 심문함.
문하	ㅁㅜㄴㅎㅏ	가르침을 받는 스승의 아래.
문호	ㅁㅜㄴㅎㅗ	뛰어난 문학 작품을 써서 널리 알려진 사람.
물가	ㅁㅜㄹㄱㅏ	바다나 강 등과 같이 물이 있는 곳의 가장자리.
물기	ㅁㅜㄹㄱㅣ	축축한 물의 기운.
물리	ㅁㅜㄹㄹㅣ	사물의 근본적인 진리나 원칙.
물자	ㅁㅜㄹㅈㅏ	어떤 활동에 필요한 물건이나 재료.
물주	ㅁㅜㄹㅈㅜ	장사 등에서 밑천이나 물자를 대는 사람.
뭉치	ㅁㅜㅇㅊㅣ	여러 개를 하나의 큰 덩어리로 만든 것.
미각	ㅁㅣㄱㅏㄱ	혀가 맛을 느끼는 감각.
미간	ㅁㅣㄱㅏㄴ	책이나 인쇄물이 아직 인쇄되어 나오지 않은 상태.
미감	ㅁㅣㄱㅏㅁ	아름다움에 대한 느낌이나 아름다운 느낌.
미개	ㅁㅣㄱㅏㅣ	문명이 발달하지 못한 상태.
미결	ㅁㅣㄱㅕㄹ	아직 결정되거나 해결되지 않음.
미곡	ㅁㅣㄱㅗㄱ	쌀을 비롯한 여러 가지 곡식들.
미국	ㅁㅣㄱㅜㄱ	북아메리카 대륙의 중앙에 있는 나라. 한국의 주요 교역국이자 국제 정치와 경제에서 중요한 위치를 차지하고 있다. 공용어는 영어이고 수도는 워싱턴이다.
미군	ㅁㅣㄱㅜㄴ	미국 군대. 또는 미국 군인.
미궁	ㅁㅣㄱㅜㅇ	길이 복잡하여 한 번 들어가면 쉽게 나오기 힘든 곳.
미끼	ㅁㅣㄱㄱㅣ	물고기나 동물을 유인하여 잡기 위해 사용하는 먹이.
미남	ㅁㅣㄴㅏㅁ	얼굴이 잘생긴 남자.
미납	ㅁㅣㄴㅏㅂ	내야 할 돈을 아직 내지 못함.
미달	ㅁㅣㄷㅏㄹ	어떤 기준이나 정도에 미치지 못하는 것.
미담	ㅁㅣㄷㅏㅁ	감동을 일으키는 아름다운 행실에 대한 이야기.
미덕	ㅁㅣㄷㅓㄱ	칭찬을 받을 만큼 아름답고 훌륭한 태도나 행위.
미동	ㅁㅣㄷㅗㅇ	매우 작은 움직임.
미등	ㅁㅣㄷㅡㅇ	자동차나 열차 등의 뒷부분에 붙은 등.
미래	ㅁㅣㄹㅏㅣ	앞으로 올 때.
미량	ㅁㅣㄹㅑㅇ	아주 적은 분량.
미력	ㅁㅣㄹㅕㄱ	(겸손하게 이르는 말로) 자신의 작은 힘이나 보잘것없는 능력.
미련	ㅁㅣㄹㅕㄴ	매우 어리석고 둔함. 또는 그러한 태도나 행동.
미륵	ㅁㅣㄹㅡㄱ	석가모니 다음으로 부처가 될 보살. 또는 그 보살을 돌로 새겨 만든 상.
미만	ㅁㅣㅁㅏㄴ	일정한 수량이나 정도에 이르지 못함.
미망	ㅁㅣㅁㅏㅇ	세상의 형편이나 실정을 잘 몰라서 혼란스러운 것. 또는 그런 상태.
미명	ㅁㅣㅁㅕㅇ	날이 다 밝기 전.
미몽	ㅁㅣㅁㅗㅇ	무엇에 홀린 듯 정신을 차리지 못하고 헛된 희망에 빠져 있는 상태.
미문	ㅁㅣㅁㅜㄴ	이전까지 듣지 못함. 또는 이전까지 없었음.
미물	ㅁㅣㅁㅜㄹ	작고 보잘것없는 벌레나 짐승.
미상	ㅁㅣㅅㅏㅇ	확실하게 알려지지 않음.
미성	ㅁㅣㅅㅓㅇ	아름다운 목소리.
미세	ㅁㅣㅅㅓㅣ	분간하기 어려울 정도로 아주 작음.
미숙	ㅁㅣㅅㅜㄱ	일에 익숙하지 않아 서투르다.
미술	ㅁㅣㅅㅜㄹ	그림이나 조각처럼 눈으로 볼 수 있는 아름다움을 표현한 예술.
미식	ㅁㅣㅅㅣㄱ	미국의 방식.
미신	ㅁㅣㅅㅣㄴ	점이나 굿과 같이 비과학적이고 비합리적인 것으로 여겨지는 믿음. 또는 그런 믿음을 가지는 것.
미싱	ㅁㅣㅅㅣㅇ	바느질을 하는 기계.
미안	ㅁㅣㅇㅏㄴ	남에게 잘못을 하여 마음이 편하지 않고 부끄러움.
미역	ㅁㅣㅇㅕㄱ	냇물이나 강물 등에 들어가 몸을 담그고 씻거나 노는 일.
미연	ㅁㅣㅇㅕㄴ	어떤 일이 일어나기 전.
미열	ㅁㅣㅇㅕㄹ	그다지 높지 않게 몸에서 나는 열.
미온	ㅁㅣㅇㅗㄴ	온도가 미지근하거나 태도가 소극적임. 또는 그런 온도나 태도.
미용	ㅁㅣㅇㅛㅇ	얼굴이나 피부, 머리를 아름답게 꾸미고 다듬는 것.
미움	ㅁㅣㅇㅜㅁ	미워하는 마음. 또는 미워하는 것.
미음	ㅁㅣㅇㅡㅁ	한글 자모 ‘ㅁ’의 이름.
미인	ㅁㅣㅇㅣㄴ	얼굴이나 몸매가 아름다운 여자.
미장	ㅁㅣㅈㅏㅇ	건축 공사에서 벽이나 천장, 바닥 등에 흙이나 시멘트 등을 바름. 또는 그런 일.
미적	ㅁㅣㅈㅓㄱ	아름다움에 관한 것.
미정	ㅁㅣㅈㅓㅇ	아직 정하지 못함.
미제	ㅁㅣㅈㅓㅣ	일이나 사건이 아직 해결되지 않음.
미진	ㅁㅣㅈㅣㄴ	아주 작은 티끌이나 먼지. 또는 작고 변변치 못한 물건.
미팅	ㅁㅣㅌㅣㅇ	사교를 목적으로 여러 명의 남녀가 함께 하는 모임.
미풍	ㅁㅣㅍㅜㅇ	주로 옛날부터 그 사회에 전해 오는 좋은 습관.
미필	ㅁㅣㅍㅣㄹ	아직 끝내지 못함.
미학	ㅁㅣㅎㅏㄱ	철학의 한 갈래로 예술 작품이 가지고 있는 아름다움의 본질과 구조에 대해 연구하는 학문.
미혹	ㅁㅣㅎㅗㄱ	무엇에 홀려 정신을 똑바로 차리지 못함.
미혼	ㅁㅣㅎㅗㄴ	아직 결혼하지 않음. 또는 그런 사람.
미화	ㅁㅣㅎㅗㅏ	보기 좋게 꾸밈.
믹서	ㅁㅣㄱㅅㅓ	과일, 야채 등을 갈아서 가루나 즙으로 만드는 기계.
민가	ㅁㅣㄴㄱㅏ	보통 사람들이 사는 집.
민도	ㅁㅣㄴㄷㅗ	국민의 생활이나 문화 수준.
민사	ㅁㅣㄴㅅㅏ	개인의 권리나 이익 문제로 인한 다툼과 같이 민법과 관계된 일.
민요	ㅁㅣㄴㅇㅛ	오래전부터 사람들의 입에서 입으로 전해 내려와 누가 언제 처음 만들었는지 알 수 없으며 민중들의 사상과 생활을 담고 있는 노래.
민자	ㅁㅣㄴㅈㅏ	민간이나 사기업에서 자본을 대거나 일을 맡음.
민주	ㅁㅣㄴㅈㅜ	주권이 국민에게 있음.
민초	ㅁㅣㄴㅊㅗ	끈질긴 생명력을 지닌 잡초처럼 꿋꿋하고 강인한 백성.
밀고	ㅁㅣㄹㄱㅗ	남의 잘못이나 죄를 몰래 일러바침.
밀도	ㅁㅣㄹㄷㅗ	물질의 부피당 질량.
밀사	ㅁㅣㄹㅅㅏ	중요한 내용이나 말, 글 등을 세상에 알리지 않고 상대방에게만 전달하려고 몰래 보내는 사람.
밀서	ㅁㅣㄹㅅㅓ	몰래 보내는 편지나 문서.
밀수	ㅁㅣㄹㅅㅜ	법적인 허가 없이 국경을 넘어 몰래 물건을 사고 파는 것.
밀어	ㅁㅣㄹㅇㅓ	남녀가 달콤하고 정답게 주고받는 이야기.
밀주	ㅁㅣㄹㅈㅜ	법적인 허가 없이 몰래 술을 담금. 또는 그 술.
밀지	ㅁㅣㄹㅈㅣ	임금이 남몰래 내리던 명령.
밍크	ㅁㅣㅇㅋㅡ	족제비와 비슷하게 생겼으며 털가죽을 고급 외투용으로 쓰는 갈색 동물.
바늘	ㅂㅏㄴㅡㄹ	옷 등을 꿰매거나 만드는 데 쓰는, 쇠로 된 가늘고 끝이 뾰족한 물건.
바닥	ㅂㅏㄷㅏㄱ	어떤 공간에서 아래쪽의 평평하고 넓은 부분.
바둑	ㅂㅏㄷㅜㄱ	가로와 세로로 줄이 그어진 네모난 판에 두 사람이 각각 흰 돌과 검은 돌을 번갈아 놓으며 승부를 겨루는 놀이.
바람	ㅂㅏㄹㅏㅁ	기압의 변화 또는 사람이나 기계에 의해 일어나는 공기의 움직임.
바랑	ㅂㅏㄹㅏㅇ	스님들이 등에 지고 다니는 자루 모양의 큰 주머니.
바순	ㅂㅏㅅㅜㄴ	두 개의 리드가 있고 목관 악기 가운데 가장 낮은 소리를 내는 악기.
바위	ㅂㅏㅇㅜㅣ	아주 큰 돌.
바퀴	ㅂㅏㅋㅜㅣ	돌리거나 굴리려고 둥글게 만든 물건.
바탕	ㅂㅏㅌㅏㅇ	사물이나 현상을 이루는 근본.
바통	ㅂㅏㅌㅗㅇ	육상 등의 릴레이 경기에서, 앞 주자가 다음 주자에게 넘겨주는 막대기.
박두	ㅂㅏㄱㄷㅜ	정해진 날짜나 시간이 가까이 다가옴.
박사	ㅂㅏㄱㅅㅏ	대학에서 주는 가장 높은 학위. 또는 그 학위를 받은 사람.
박수	ㅂㅏㄱㅅㅜ	기쁨, 축하, 환영, 칭찬 등을 나타내거나 장단을 맞추려고 두 손뼉을 마주 침.
박스	ㅂㅏㄱㅅㅡ	물건을 넣어 둘 수 있도록 나무나 종이 등으로 만든 네모난 통.
박자	ㅂㅏㄱㅈㅏ	음악에서, 센 소리와 여린 소리가 규칙적으로 반복되면서 생기는 리듬. 또는 그 단위.
박차	ㅂㅏㄱㅊㅏ	말을 탈 때 신는 신발의 뒤축에 달린 톱니바퀴 모양의 쇠.
박토	ㅂㅏㄱㅌㅗ	매우 메마른 땅.
반구	ㅂㅏㄴㄱㅜ	구의 절반. 또는 그런 모양의 물체.
반기	ㅂㅏㄴㄱㅣ	반대하는 뜻을 나타내는 행동이나 표시.
반도	ㅂㅏㄴㄷㅗ	바다쪽으로 좁게 튀어나온 삼면이 바다로 둘러싸이고 한 면은 육지에 이어진 땅.
반디	ㅂㅏㄴㄷㅣ	꽁무니에서 빛을 내며 날아다니는 곤충.
반라	ㅂㅏㄴㄹㅏ	거의 아무것도 입지 않고 벌거벗은 몸.
반려	ㅂㅏㄴㄹㅕ	짝이 되는 사람이나 동물.
반미	ㅂㅏㄴㅁㅣ	미국에 반대함. 또는 미국에 반대되는 것.
반보	ㅂㅏㄴㅂㅗ	한 걸음의 반.
반사	ㅂㅏㄴㅅㅏ	빛이나 전파 등이 다른 물체의 표면에 부딪혀서 나아가던 방향이 반대 방향으로 바뀌는 현상.
반수	ㅂㅏㄴㅅㅜ	전체를 둘로 똑같이 나눈 수.
반어	ㅂㅏㄴㅇㅓ	말이나 글을 효과적으로 표현하기 위하여 본래의 의도와 반대로 표현하는 것.
반주	ㅂㅏㄴㅈㅜ	노래나 기악 연주를 돕기 위해 다른 악기를 연주함. 또는 그런 연주.
반지	ㅂㅏㄴㅈㅣ	손가락에 끼는 동그란 장신구.
반추	ㅂㅏㄴㅊㅜ	어떤 일을 여러 번 계속하여 생각함. 또는 그런 일.
반파	ㅂㅏㄴㅍㅏ	반 정도 부서짐.
반포	ㅂㅏㄴㅍㅗ	널리 퍼뜨려 모두 알게 함.
발기	ㅂㅏㄹㄱㅣ	남성의 성기가 크게 부풀거나 꼿꼿하게 서는 일.
발로	ㅂㅏㄹㄹㅗ	어떠한 것에 숨어 있는 것이 겉으로 드러나거나 숨은 것을 겉으로 드러냄.
발모	ㅂㅏㄹㅁㅗ	머리카락 등의 털이 몸에 남.
발부	ㅂㅏㄹㅂㅜ	공공 기관 등에서 각종 서류나 증명서 등을 발행함.
발사	ㅂㅏㄹㅅㅏ	활, 총, 대포, 로켓이나 전파, 음파 등을 쏘는 것.
발아	ㅂㅏㄹㅇㅏ	풀이나 나무의 눈이 나옴.
발주	ㅂㅏㄹㅈㅜ	공사나 용역 같은 큰 규모의 거래에서 물건이나 서비스 등을 주문함.
발차	ㅂㅏㄹㅊㅏ	버스나 기차 등이 떠남.
발치	ㅂㅏㄹㅊㅣ	누웠을 때 발이 있는 쪽.
발파	ㅂㅏㄹㅍㅏ	바위나 단단한 물체에 구멍을 뚫고 폭약을 넣어서 폭파시킴.
발포	ㅂㅏㄹㅍㅗ	국가 기관에서 법령이나 정책 등을 세상에 널리 알림.
발표	ㅂㅏㄹㅍㅛ	어떤 사실이나 결과, 작품 등을 세상에 드러내어 널리 알림.
발호	ㅂㅏㄹㅎㅗ	권력을 마음대로 휘두르며 함부로 행동함.
발효	ㅂㅏㄹㅎㅛ	조약, 법, 공문서 등의 효력이 나타남. 또는 그 효력을 나타냄.
밤비	ㅂㅏㅁㅂㅣ	밤에 내리는 비.
밤차	ㅂㅏㅁㅊㅏ	밤에 다니는 버스나 기차.
방기	ㅂㅏㅇㄱㅣ	책임이나 의무 등을 무시하여 관심을 갖거나 돌보지 않음.
방뇨	ㅂㅏㅇㄴㅛ	오줌을 눔.
방도	ㅂㅏㅇㄷㅗ	어떤 일이나 문제를 해결해 나갈 방법.
방류	ㅂㅏㅇㄹㅠ	모아 둔 물을 흘려 보냄.
방비	ㅂㅏㅇㅂㅣ	자연 재해나 적의 공격에 의한 피해를 막기 위하여 미리 대비함. 또는 그런 수단이나 시설.
방사	ㅂㅏㅇㅅㅏ	남녀가 성적으로 관계를 맺는 일.
방수	ㅂㅏㅇㅅㅜ	물이 새거나 스며들거나 흐르지 않도록 막음.
방아	ㅂㅏㅇㅇㅏ	곡식을 찧거나 빻는 기구.
방어	ㅂㅏㅇㅇㅓ	공격이나 위협을 막음.
방조	ㅂㅏㅇㅈㅗ	다른 사람이 범죄를 저지르는 것을 도와주는 행위.
방지	ㅂㅏㅇㅈㅣ	어떤 좋지 않은 일이나 현상이 일어나지 않도록 막음.
방치	ㅂㅏㅇㅊㅣ	무관심하게 그대로 내버려 둠.
방호	ㅂㅏㅇㅎㅗ	공격이나 위험을 막아 안전하게 보호함.
배가	ㅂㅏㅣㄱㅏ	두 배 또는 몇 배로 늘어남. 또는 그렇게 늘림.
배교	ㅂㅏㅣㄱㅛ	믿던 종교를 버리고 다른 종교로 바꾸거나 아무것도 믿지 않게 됨.
배구	ㅂㅏㅣㄱㅜ	직사각형의 코트 가운데에 그물을 두고 공을 땅에 떨어뜨리지 않으면서 손으로 쳐서 상대편에게 넘겨 보내는 경기.
배기	ㅂㅏㅣㄱㅣ	안에 든 기체를 밖으로 뽑아냄.
배뇨	ㅂㅏㅣㄴㅛ	오줌을 눔.
배려	ㅂㅏㅣㄹㅕ	관심을 가지고 보살펴 주거나 도와줌.
배부	ㅂㅏㅣㅂㅜ	책이나 서류, 표 등을 나누어 줌.
배수	ㅂㅏㅣㅅㅜ	바다, 강, 호수 등의 물을 뒤에 등지고 있음. 또는 그 물.
배아	ㅂㅏㅣㅇㅏ	식물의 씨 속에 있는 앞으로 싹이 될 부분.
배우	ㅂㅏㅣㅇㅜ	영화나 연극, 드라마 등에 나오는 인물의 역할을 맡아서 연기하는 사람.
배지	ㅂㅏㅣㅈㅣ	신분이나 소속을 알리거나 어떤 뜻을 나타내기 위하여 웃옷이나 모자 등에 붙이는 작은 물건.
배차	ㅂㅏㅣㅊㅏ	일정한 선로 또는 구간에 자동차나 기차 등을 나누어 두거나 나누어 보냄.
배추	ㅂㅏㅣㅊㅜ	길고 둥근 잎이 포개져 자라는, 속은 누런 흰색이고 겉은 녹색이며 김칫거리로 많이 쓰이는 채소.
배치	ㅂㅏㅣㅊㅣ	서로 반대가 되어 맞지 아니함.
배타	ㅂㅏㅣㅌㅏ	남을 싫어하여 거부하고 따돌림.
배트	ㅂㅏㅣㅌㅡ	야구나 소프트볼 등의 경기에서, 공을 치는 방망이.
배포	ㅂㅏㅣㅍㅗ	신문이나 책 등을 널리 나누어 줌.
배표	ㅂㅏㅣㅍㅛ	배를 타기 위해 돈을 내고 사는 표.
배후	ㅂㅏㅣㅎㅜ	어떤 대상이나 무리의 뒤쪽.
버들	ㅂㅓㄷㅡㄹ	4월 무렵에 어두운 자주색의 꽃이 피고 녹색 잎이 붙은 가늘고 긴 가지가 있으며 개울가나 습지에 잘 자라는 나무.
버릇	ㅂㅓㄹㅡㅅ	오랫동안 자꾸 반복하여 몸에 익숙해진 성질이나 행동.
버선	ㅂㅓㅅㅓㄴ	천으로 발 모양과 비슷하게 만들어 주로 한복을 입을 때 양말처럼 발에 신는 물건.
버섯	ㅂㅓㅅㅓㅅ	그늘지고 물기가 많은 땅이나 썩은 나무에서 자라며 주로 우산처럼 생겼고 음식의 재료로 쓰이는 식물.
버짐	ㅂㅓㅈㅣㅁ	주로 얼굴의 피부가 하얗게 일어나거나 진물이 나는 피부병.
버찌	ㅂㅓㅈㅈㅣ	맛이 새콤하고 단, 벚나무의 열매.
버튼	ㅂㅓㅌㅡㄴ	전기 장치에서 손가락으로 눌러 조작할 수 있게 만들어 놓은 장치.
번지	ㅂㅓㄴㅈㅣ	지역을 일정한 기준에 따라 나누고 그 각각에 붙인 번호.
번트	ㅂㅓㄴㅌㅡ	야구에서, 타자가 친 공이 가까운 거리에 떨어지도록 방망이를 공에 가볍게 대어 맞추는 일.
번호	ㅂㅓㄴㅎㅗ	차례를 나타내거나 서로 다른 것과 구별하기 위해 붙이는 숫자.
벌이	ㅂㅓㄹㅇㅣ	일을 하여 돈이나 재물을 벎.
벌초	ㅂㅓㄹㅊㅗ	무덤과 그 주변의 풀을 베어서 깨끗이 함.
범부	ㅂㅓㅁㅂㅜ	평범한 사람.
범사	ㅂㅓㅁㅅㅏ	모든 일.
범주	ㅂㅓㅁㅈㅜ	같은 성질을 가진 부류나 범위.
범퍼	ㅂㅓㅁㅍㅓ	충돌 사고가 생겼을 때 충격을 덜 받게 하기 위하여 자동차의 앞과 뒤에 설치한 장치.
법규	ㅂㅓㅂㄱㅠ	법으로 정해져서 지키거나 따라야 할 규칙이나 규범.
법도	ㅂㅓㅂㄷㅗ	생활에서 지켜야 할 예절과 제도.
법리	ㅂㅓㅂㄹㅣ	법의 원리.
법치	ㅂㅓㅂㅊㅣ	법에 따라 나라를 다스림.
벙커	ㅂㅓㅇㅋㅓ	골프장의 코스 중에서 모래로만 되어 있는 우묵한 곳.
벼락	ㅂㅕㄹㅏㄱ	하늘에서 큰 소리를 내며 번쩍이는 빛의 줄기가 내리치는 자연 현상.
벼랑	ㅂㅕㄹㅏㅇ	낭떠러지의 험하고 가파른 언덕.
벼룩	ㅂㅕㄹㅜㄱ	사람과 동물의 피를 빨아 먹으면서 병을 옮기는 아주 작고 해로운 곤충.
벼슬	ㅂㅕㅅㅡㄹ	(옛날에) 나랏일을 하는 관리의 직분이나 자리.
벽두	ㅂㅕㄱㄷㅜ	맨 처음. 또는 어떤 시기나 일이 시작되는 첫머리.
벽보	ㅂㅕㄱㅂㅗ	여러 사람에게 널리 알리기 위하여 벽이나 게시판 등에 붙이는 글.
벽지	ㅂㅕㄱㅈㅣ	도시에서 멀리 떨어져 있는 외진 곳.
변고	ㅂㅕㄴㄱㅗ	뜻밖에 일어난 갑작스러운 사고.
변기	ㅂㅕㄴㄱㅣ	똥이나 오줌을 눌 수 있게 화장실에 설치해 두는 기구.
변모	ㅂㅕㄴㅁㅗ	모양이나 모습이 바뀌거나 달라짐. 또는 그런 모양이나 모습.
변비	ㅂㅕㄴㅂㅣ	똥이 대장에서 오랫동안 굳어 있어 잘 나오지 않는 증세.
변사	ㅂㅕㄴㅅㅏ	무성 영화에 맞추어 그 줄거리를 설명하고 대화를 흉내 내어 말하던 사람.
변소	ㅂㅕㄴㅅㅗ	사람이 대소변을 볼 수 있게 만들어 놓은 곳.
변수	ㅂㅕㄴㅅㅜ	어떤 일에 변화를 일으킬 수 있는 요인.
변조	ㅂㅕㄴㅈㅗ	이미 만들어진 물건을 손질하여 다른 모양이나 다른 물건으로 바꾸어 만듦.
변주	ㅂㅕㄴㅈㅜ	음악 연주나 예술 창작에서, 하나의 주제를 바탕으로 가락, 리듬, 내용, 성질 등을 조금씩 바꾸어 연주하거나 만듦. 또는 그런 연주나 작품.
변호	ㅂㅕㄴㅎㅗ	다른 사람을 위해 감싸고 변명함.
별거	ㅂㅕㄹㄱㅓ	흔하지 않은 이상한 것.
별고	ㅂㅕㄹㄱㅗ	특별한 사고.
별도	ㅂㅕㄹㄷㅗ	원래의 것에 덧붙여 추가되거나 따로 마련된 것.
별미	ㅂㅕㄹㅁㅣ	특별히 좋은 맛. 또는 그런 맛을 가진 음식.
별수	ㅂㅕㄹㅅㅜ	달리 어떻게 할 방법.
별지	ㅂㅕㄹㅈㅣ	문서에 따로 덧붙이는 종이.
별차	ㅂㅕㄹㅊㅏ	특별히 다른 차이.
별표	ㅂㅕㄹㅍㅛ	별 모양의 표.
별호	ㅂㅕㄹㅎㅗ	본래의 이름이나 자 외에, 친근하게 부르기 위해 지어서 쓰는 이름.
병가	ㅂㅕㅇㄱㅏ	병 때문에 얻는 휴가.
병고	ㅂㅕㅇㄱㅗ	병으로 인한 고통.
병기	ㅂㅕㅇㄱㅣ	전쟁에 쓰이는 기구.
병리	ㅂㅕㅇㄹㅣ	병의 종류, 원인, 발생, 진행 과정 등에 관한 이론.
병마	ㅂㅕㅇㅁㅏ	병사와 군사용 말.
병무	ㅂㅕㅇㅁㅜ	군대나 군비 등의 군과 관련된 업무.
병사	ㅂㅕㅇㅅㅏ	(옛날에) 군인이나 군대.
병서	ㅂㅕㅇㅅㅓ	군사를 지휘하여 전투를 이끌어 나가는 방법에 대하여 쓴 책.
병자	ㅂㅕㅇㅈㅏ	병에 걸려 아픈 상태에 있는 사람.
병후	ㅂㅕㅇㅎㅜ	병을 앓고 난 뒤.
보강	ㅂㅗㄱㅏㅇ	원래보다 더 튼튼하게 하기 위하여 보태거나 채움.
보건	ㅂㅗㄱㅓㄴ	병의 예방이나 치료 등을 통해 건강을 잘 지킴.
보격	ㅂㅗㄱㅕㄱ	문장 안에서 체언이 서술어의 보어임을 표시하는 격.
보결	ㅂㅗㄱㅕㄹ	사람이 빠져 생긴 정원의 빈자리를 채움.
보급	ㅂㅗㄱㅡㅂ	어떤 것을 널리 퍼뜨려 여러 곳에 미치게 하거나 여러 사람이 누리게 함.
보답	ㅂㅗㄷㅏㅂ	남에게 받은 은혜나 고마움을 갚음.
보람	ㅂㅗㄹㅏㅁ	어떤 일을 한 뒤에 얻는 좋은 결과나 만족한 느낌.
보름	ㅂㅗㄹㅡㅁ	음력으로 그달의 십오 일이 되는 날.
보물	ㅂㅗㅁㅜㄹ	높은 가치가 있는 매우 귀하고 소중한 물건.
보배	ㅂㅗㅂㅏㅣ	매우 귀하고 소중한 물건. 또는 사람.
보병	ㅂㅗㅂㅕㅇ	걸어서 이동하며 총 등으로 적을 공격하는, 육군에서 가장 중심이 되는 군인.
보복	ㅂㅗㅂㅗㄱ	남에게 해를 입은 것에 대한 복수로 상대방에게도 그만큼의 해를 입힘.
보살	ㅂㅗㅅㅏㄹ	불교에서, 위로는 부처를 따르고 아래로는 중생을 이끄는, 부처의 다음가는 성인.
보상	ㅂㅗㅅㅏㅇ	남에게 진 빚이나 받은 물건을 갚음.
보석	ㅂㅗㅅㅓㄱ	피고인을 돈을 받거나 보증하는 사람을 세워 재판하기 전까지 풀어 줌.
보선	ㅂㅗㅅㅓㄴ	‘보궐 선거’를 줄여 이르는 말.
보신	ㅂㅗㅅㅣㄴ	자신의 몸이나 안전을 온전히 지킴.
보안	ㅂㅗㅇㅏㄴ	중요한 정보 등이 빠져나가서 위험이나 문제가 생기지 않도록 안전한 상태로 유지하고 보호함.
보약	ㅂㅗㅇㅑㄱ	몸의 기운을 높여 주고 건강하도록 도와주는 약.
보양	ㅂㅗㅇㅑㅇ	잘 보호하여 기름.
보온	ㅂㅗㅇㅗㄴ	따뜻한 온도를 일정하게 유지함.
보위	ㅂㅗㅇㅜㅣ	공격을 막아서 지키고 보호함.
보육	ㅂㅗㅇㅠㄱ	어린아이들을 돌보아 가르치고 기름.
보은	ㅂㅗㅇㅡㄴ	은혜를 갚음.
보장	ㅂㅗㅈㅏㅇ	잘못되는 일이 없도록 보증하거나 보호함.
보전	ㅂㅗㅈㅓㄴ	변하는 것이 없도록 잘 지키고 유지함.
보정	ㅂㅗㅈㅓㅇ	부족한 부분을 보태거나 고쳐서 바르게 함.
보존	ㅂㅗㅈㅗㄴ	중요한 것을 잘 보호하여 그대로 남김.
보좌	ㅂㅗㅈㅗㅏ	자기보다 높은 지위에 있는 사람을 도와서 일을 처리함.
보증	ㅂㅗㅈㅡㅇ	어떤 사람이나 사물에 대하여 책임지고 틀림이 없음을 증명함.
보직	ㅂㅗㅈㅣㄱ	어떤 직위와 함께 맡을 일을 줌. 또는 그 직위.
보충	ㅂㅗㅊㅜㅇ	부족한 것을 보태어 채움.
보통	ㅂㅗㅌㅗㅇ	흔히 볼 수 있어 특별하지 않고 평범함. 또는 뛰어나지도 뒤떨어지지도 않은 중간 정도.
보편	ㅂㅗㅍㅕㄴ	모든 것에 두루 미치거나 통함. 또는 그런 것.
보폭	ㅂㅗㅍㅗㄱ	걸음을 걸을 때 앞발과 뒷발 사이의 간격.
보풀	ㅂㅗㅍㅜㄹ	종이나 헝겊의 겉에 일어나는 가느다란 털.
보필	ㅂㅗㅍㅣㄹ	가까이에서 윗사람의 일을 도움. 또는 그런 사람.
보험	ㅂㅗㅎㅓㅁ	미래의 재해나 질병 등에 대하여 금전적 보상을 받기 위해 정해진 기간 동안 일정한 돈을 납부해 적립해 두는 제도.
보화	ㅂㅗㅎㅗㅏ	드물고 귀해서 값이 비싼 물건.
보훈	ㅂㅗㅎㅜㄴ	나라를 위해 들인 큰 수고와 노력에 보답함.
복고	ㅂㅗㄱㄱㅗ	과거의 모양, 제도, 사상, 풍습 등으로 돌아감.
복구	ㅂㅗㄱㄱㅜ	고장 나거나 파괴된 것을 이전의 상태로 되돌림.
복도	ㅂㅗㄱㄷㅗ	건물 안에서 여러 방으로 통하게 만들어 놓은 통로.
복리	ㅂㅗㄱㄹㅣ	행복과 이익.
복무	ㅂㅗㄱㅁㅜ	일정한 직무나 임무를 맡아 일함.
복부	ㅂㅗㄱㅂㅜ	신체 중에서 배 부분.
복사	ㅂㅗㄱㅅㅏ	원래의 것을 다른 곳에 그대로 옮겨 놓음.
복수	ㅂㅗㄱㅅㅜ	자기나 자기의 가족 등에게 해를 끼친 사람에게 원수를 갚음.
복어	ㅂㅗㄱㅇㅓ	몸이 똥똥하고 비늘이 없으며 알과 내장에 강한 독이 있으나, 살은 회나 국거리로 쓰는 바닷물고기.
복지	ㅂㅗㄱㅈㅣ	편안하고 행복하게 사는 삶.
본가	ㅂㅗㄴㄱㅏ	따로 나와 살기 이전에 원래 살던 집.
본고	ㅂㅗㄴㄱㅗ	글쓴이 자신이 쓴 글.
본교	ㅂㅗㄴㄱㅛ	갈라져서 다른 지역에 따로 세운 학교에 대하여 그 바탕이 되는 학교.
본드	ㅂㅗㄴㄷㅡ	나무, 가죽, 고무 등의 물체를 붙이기 위해 쓰는 물질.
본디	ㅂㅗㄴㄷㅣ	전하여 내려온 그 처음.
본류	ㅂㅗㄴㄹㅠ	강이나 그보다 작은 물줄기의 처음을 이루는 물줄기.
본무	ㅂㅗㄴㅁㅜ	어떤 직책이나 직업과 관련하여 가장 중심이 되는 일.
본부	ㅂㅗㄴㅂㅜ	기관의 중심이 되는 조직. 또는 그 조직이 있는 곳.
본사	ㅂㅗㄴㅅㅏ	곳곳에 지사를 두고 있는 회사의 중심이 되는 사업체.
본서	ㅂㅗㄴㅅㅓ	중심이 되는 관서나 경찰서.
본시	ㅂㅗㄴㅅㅣ	전하여 내려온 그 처음.
본지	ㅂㅗㄴㅈㅣ	근본이 되는 뜻이나 목적.
본처	ㅂㅗㄴㅊㅓ	첩과 상대하여 쓰는 말로, 아내.
본토	ㅂㅗㄴㅌㅗ	딸린 섬, 식민지, 피보호국 등에 대하여 주가 되는 국토.
볼기	ㅂㅗㄹㄱㅣ	뒤쪽 허리 아래, 허벅지 위의 양쪽으로 살이 불룩한 부분.
볼모	ㅂㅗㄹㅁㅗ	약속을 지키겠다는 뜻으로 상대편에 잡혀 두는 사람이나 물건.
볼트	ㅂㅗㄹㅌㅡ	두 물체를 죄는 데 쓰는, 육각이나 사각의 머리를 가진 나사.
봄비	ㅂㅗㅁㅂㅣ	봄에 내리는 비.
봉기	ㅂㅗㅇㄱㅣ	아주 많은 사람들이 정권에 반대하거나 항의하여 나섬.
봉사	ㅂㅗㅇㅅㅏ	(낮잡아 이르는 말로) 앞을 보지 못하는 사람.
봉지	ㅂㅗㅇㅈㅣ	안에 물건을 넣을 수 있게 종이나 비닐 등으로 만든 주머니.
봉투	ㅂㅗㅇㅌㅜ	편지나 서류 등을 넣기 위해 종이로 만든 주머니.
부각	ㅂㅜㄱㅏㄱ	어떤 특징을 두드러지게 함.
부강	ㅂㅜㄱㅏㅇ	나라의 살림이 넉넉하고 군사력이 강함.
부검	ㅂㅜㄱㅓㅁ	죽은 원인을 밝히기 위해 시신을 살핌. 또는 그런 일.
부결	ㅂㅜㄱㅕㄹ	회의에서 의논한 안건을 반대하여 받아들이지 않기로 결정함. 또는 그런 결정.
부계	ㅂㅜㄱㅕㅣ	혈연 관계에서 아버지 쪽의 계통.
부과	ㅂㅜㄱㅗㅏ	세금이나 벌금 등을 매겨서 내게 함.
부국	ㅂㅜㄱㅜㄱ	나라를 부유하게 만듦. 또는 그런 나라.
부군	ㅂㅜㄱㅜㄴ	(높이는 말로) 남의 남편.
부귀	ㅂㅜㄱㅜㅣ	재산이 많고 지위가 높음.
부근	ㅂㅜㄱㅡㄴ	어떤 곳을 중심으로 그 곳에서 가까운 곳.
부금	ㅂㅜㄱㅡㅁ	빚을 갚거나 저축을 하려고 일정 기간 동안 내는 돈.
부농	ㅂㅜㄴㅗㅇ	농사지을 땅을 많이 가지고 있어서 농사를 크게 짓고 수입이 많아 생활이 넉넉한 농가나 농민.
부담	ㅂㅜㄷㅏㅁ	일을 맡거나 책임, 의무를 짐.
부당	ㅂㅜㄷㅏㅇ	도리에 어긋나서 정당하지 않음.
부대	ㅂㅜㄷㅏㅣ	주된 것에 딸려서 덧붙임.
부덕	ㅂㅜㄷㅓㄱ	덕이 없거나 부족함.
부동	ㅂㅜㄷㅗㅇ	물건이나 몸, 지위가 움직이지 않음.
부락	ㅂㅜㄹㅏㄱ	주로 시골에서, 여러 집이 모여 사는 곳.
부럼	ㅂㅜㄹㅓㅁ	음력 1월 15일에 한 해 동안의 나쁜 기운을 물리치려고 깨물어 먹는 땅콩, 밤, 호두 등의 딱딱한 열매류.
부력	ㅂㅜㄹㅕㄱ	액체나 기체 속에 있는 물체를 위로 떠오르게 하는 힘.
부록	ㅂㅜㄹㅗㄱ	본문 뒤에 참고 자료로 덧붙이는 내용.
부름	ㅂㅜㄹㅡㅁ	오라고 불러들이거나 부르는 것.
부목	ㅂㅜㅁㅗㄱ	팔다리가 부러지거나 다쳤을 때, 팔다리를 움직이지 못하도록 고정하기 위해 임시로 대는 나무.
부문	ㅂㅜㅁㅜㄴ	어떤 분야를 구별하여 갈라놓은 특정한 부분이나 영역.
부분	ㅂㅜㅂㅜㄴ	전체를 이루고 있는 작은 범위. 또는 전체를 여러 개로 나눈 것 가운데 하나.
부산	ㅂㅜㅅㅏㄴ	정신이 없을 만큼 어지럽거나 시끄러움.
부삽	ㅂㅜㅅㅏㅂ	아궁이나 화로의 재를 꺼내거나, 숯불이나 불을 담아 옮기는 데 쓰는 작은 삽.
부상	ㅂㅜㅅㅏㅇ	몸에 상처를 입음.
부설	ㅂㅜㅅㅓㄹ	어떤 기관에 딸리게 하여 설치함. 또는 그런 시설.
부성	ㅂㅜㅅㅓㅇ	남성이 아버지로서 지니는 본능적인 성질.
부속	ㅂㅜㅅㅗㄱ	주된 것에 딸려 붙음. 또는 그렇게 딸려 붙어 있는 것.
부식	ㅂㅜㅅㅣㄱ	주로 먹는 음식에 함께 곁들여 먹는 음식.
부실	ㅂㅜㅅㅣㄹ	몸이 튼튼하지 못하고 약함.
부심	ㅂㅜㅅㅣㅁ	운동 경기에서, 주심을 도와 부분적인 사항을 심판하는 사람.
부양	ㅂㅜㅇㅑㅇ	수입이 없어서 혼자 생활하기 어려운 사람을 돌봄.
부업	ㅂㅜㅇㅓㅂ	본래의 직업이 아닌, 돈을 벌기 위하여 남는 시간에 하는 일.
부엌	ㅂㅜㅇㅓㅋ	집에서 음식을 만들고 설거지를 하는 등 식사와 관련된 일을 하는 장소.
부역	ㅂㅜㅇㅕㄱ	국가에 반역하는 일을 돕거나 함께 함.
부연	ㅂㅜㅇㅕㄴ	알기 쉽게 다른 내용을 더하여 자세히 말함.
부위	ㅂㅜㅇㅜㅣ	몸의 전체에서 어느 특정 부분이 있는 위치.
부음	ㅂㅜㅇㅡㅁ	사람이 죽은 것을 알리는 소식.
부응	ㅂㅜㅇㅡㅇ	기대나 요구 등에 따라 응함.
부의	ㅂㅜㅇㅡㅣ	장례를 치르는 집을 돕기 위하여 보내는 돈이나 물품. 또는 그것을 보내는 일.
부인	ㅂㅜㅇㅣㄴ	(높이는 말로) 다른 사람의 아내.
부임	ㅂㅜㅇㅣㅁ	어떤 지위나 임무를 받아 근무할 곳으로 감.
부장	ㅂㅜㅈㅏㅇ	기관, 조직 등에서 한 부를 책임지고 다스리는 직위. 또는 그 직위에 있는 사람.
부재	ㅂㅜㅈㅏㅣ	어떤 것이 있지 않음.
부적	ㅂㅜㅈㅓㄱ	잡귀를 쫓고 재앙을 물리치기 위하여 붉은 색으로 글씨를 쓰거나 그림을 그려 몸에 지니거나 집에 붙이는 종이.
부정	ㅂㅜㅈㅓㅇ	옳지 않음. 또는 그런 행위.
부제	ㅂㅜㅈㅓㅣ	책, 논문 등의 제목에 덧붙어 그것을 보충하는 작은 제목.
부족	ㅂㅜㅈㅗㄱ	필요한 양이나 기준에 모자라거나 넉넉하지 않음.
부중	ㅂㅜㅈㅜㅇ	‘부속 중학교’를 줄여 이르는 말.
부진	ㅂㅜㅈㅣㄴ	어떤 일이 좋은 쪽으로 이루어지는 기세가 활발하지 않음.
부착	ㅂㅜㅊㅏㄱ	떨어지지 않게 붙이거나 닮.
부채	ㅂㅜㅊㅏㅣ	손으로 잡고 흔들어 바람을 일으키는 도구.
부촌	ㅂㅜㅊㅗㄴ	부자들이 모여 사는 동네.
부축	ㅂㅜㅊㅜㄱ	다른 사람이 몸을 움직이는 것을 곁에서 도와줌.
부칙	ㅂㅜㅊㅣㄱ	어떤 규정이나 법률을 보충하기 위하여 덧붙이는 규정이나 규칙.
부친	ㅂㅜㅊㅣㄴ	자기 혹은 다른 사람의 아버지를 정중하게 이르는 말.
부침	ㅂㅜㅊㅣㅁ	달걀을 입힌 식재료나 여러 가지 식재료를 넣은 걸죽한 반죽을 기름에 부쳐 낸 음식.
부케	ㅂㅜㅋㅓㅣ	결혼식에서 신부가 손에 드는 작은 꽃다발.
부탁	ㅂㅜㅌㅏㄱ	어떤 일을 해 달라고 하거나 맡김.
부탄	ㅂㅜㅌㅏㄴ	아시아의 남부, 히말라야 산기슭에 있는 나라. 국토의 대부분이 산악 지대이며, 주요 생산물로는 쌀, 밀 등이 있다. 주요 언어는 티베트어이고 수도는 팀푸이다.
부패	ㅂㅜㅍㅏㅣ	단백질이나 지방 등이 미생물의 작용에 의하여 썩는 것.
부페	ㅂㅜㅍㅓㅣ	→ 뷔페
부풀	ㅂㅜㅍㅜㄹ	종이나 헝겊의 겉에 일어나는 가느다란 털.
부품	ㅂㅜㅍㅜㅁ	기계 등의 전체 중 어느 한 부분을 이루는 물건.
부합	ㅂㅜㅎㅏㅂ	서로 맞대어 붙임.
부형	ㅂㅜㅎㅕㅇ	아버지와 형.
부화	ㅂㅜㅎㅗㅏ	동물의 알 속에서 새끼가 껍데기를 깨고 밖으로 나옴. 또는 그렇게 되게 함.
부흥	ㅂㅜㅎㅡㅇ	기세가 약해졌던 것이 다시 활발하게 일어남. 또는 그렇게 되게 함.
북미	ㅂㅜㄱㅁㅣ	아메리카 대륙의 북부.
북부	ㅂㅜㄱㅂㅜ	어떤 지역의 북쪽 부분.
북서	ㅂㅜㄱㅅㅓ	북쪽과 서쪽 사이.
북어	ㅂㅜㄱㅇㅓ	내장을 빼내고 말린 명태.
분가	ㅂㅜㄴㄱㅏ	같이 살던 가족의 일부가 집을 나가 따로 살림을 차림.
분교	ㅂㅜㄴㄱㅛ	본교와 떨어진 다른 지역에 세운, 본교에 속해 있는 학교.
분규	ㅂㅜㄴㄱㅠ	여러 사람이 각자 자기에게 이로운 것을 따지고 서로 다투는 것.
분기	ㅂㅜㄴㄱㅣ	일 년을 넷으로 나눈 삼 개월씩의 기간.
분노	ㅂㅜㄴㄴㅗ	몹시 화를 냄.
분뇨	ㅂㅜㄴㄴㅛ	똥과 오줌.
분류	ㅂㅜㄴㄹㅠ	여럿을 종류에 따라서 나눔.
분리	ㅂㅜㄴㄹㅣ	서로 나뉘어 떨어짐. 또는 그렇게 되게 함.
분모	ㅂㅜㄴㅁㅗ	분수나 분수식에서, 가로줄 아래에 있는 수 또는 식.
분부	ㅂㅜㄴㅂㅜ	윗사람이 아랫사람에게 하는 명령이나 당부.
분비	ㅂㅜㄴㅂㅣ	세포에서 만들어진 액체를 세포 밖으로 내보내는 것.
분사	ㅂㅜㄴㅅㅏ	액체나 기체 등에 압력을 가하여 세차게 뿜어 내보냄.
분수	ㅂㅜㄴㅅㅜ	사물이나 현상을 분별하는 지혜.
분야	ㅂㅜㄴㅇㅑ	사회 활동을 어떠한 기준에 따라 나눈 범위나 부분 중의 하나.
분유	ㅂㅜㄴㅇㅠ	우유의 물기를 없애고 만든 가루.
분자	ㅂㅜㄴㅈㅏ	어떤 물질의 화학적 형태와 성질을 띠고 있는 가장 작은 알갱이.
분지	ㅂㅜㄴㅈㅣ	주위가 더 높은 지형으로 둘러싸인 평지.
분투	ㅂㅜㄴㅌㅜ	문제를 해결하거나 목표를 이루기 위해서 있는 힘을 다하여 노력함.
분파	ㅂㅜㄴㅍㅏ	한 집단이나 사상 등에서 여러 갈래로 나뉘어 갈라짐. 또는 그렇게 나뉜 갈래.
분포	ㅂㅜㄴㅍㅗ	일정한 범위에 나뉘어 흩어져 있음.
불가	ㅂㅜㄹㄱㅏ	옳지 않음.
불교	ㅂㅜㄹㄱㅛ	인도의 석가모니에 의해 만들어져, 이 세상의 모든 고통에서 벗어나 부처가 되는 것을 이상으로 삼는 종교.
불구	ㅂㅜㄹㄱㅜ	몸의 어느 부분이 온전하지 못함. 또는 그런 상태.
불기	ㅂㅜㄹㄱㅣ	불에서 나오는 뜨거운 느낌.
불리	ㅂㅜㄹㄹㅣ	조건이나 입장 등이 이익이 되지 않음.
불모	ㅂㅜㄹㅁㅗ	땅이 거칠고 메말라 식물이 나거나 자라지 않음.
불사	ㅂㅜㄹㅅㅏ	거절하거나 마다하지 않음.
불소	ㅂㅜㄹㅅㅗ	자극적인 냄새가 나고 연한 누런빛을 띠며, 충치 예방을 위하여 수돗물이나 치약 등에 쓰이는 기체.
불시	ㅂㅜㄹㅅㅣ	뜻하지 않은 때.
불어	ㅂㅜㄹㅇㅓ	주로 프랑스 사람들이 쓰는 언어.
불우	ㅂㅜㄹㅇㅜ	살림이나 처지가 딱하고 어려움.
불치	ㅂㅜㄹㅊㅣ	병이 잘 낫지 않음. 또는 병을 고치지 못함.
불티	ㅂㅜㄹㅌㅣ	타는 불에서 튀는 작은 불똥.
불하	ㅂㅜㄹㅎㅏ	국가 또는 공공 단체의 재산을 개인에게 팔아넘기는 일.
불허	ㅂㅜㄹㅎㅓ	허락하지 않음.
불효	ㅂㅜㄹㅎㅛ	부모를 공경하지 않고 잘 받들지 않음.
불후	ㅂㅜㄹㅎㅜ	훌륭한 가치나 의의가 영원히 변하거나 없어지지 않음.
붕어	ㅂㅜㅇㅇㅓ	몸이 넓적하고 등은 주로 누런빛을 띤 갈색이며 비늘이 큰, 민물에 사는 물고기.
비결	ㅂㅣㄱㅕㄹ	세상에 알려지지 않은 자기만의 뛰어난 방법.
비계	ㅂㅣㄱㅕㅣ	돼지나 소 같은 동물의 가죽 안쪽에 붙어 있는 두꺼운 기름 층.
비극	ㅂㅣㄱㅡㄱ	매우 슬프고 비참한 일.
비난	ㅂㅣㄴㅏㄴ	다른 사람의 잘못이나 결점에 대하여 나쁘게 말함.
비늘	ㅂㅣㄴㅡㄹ	물고기나 뱀의 겉 부분을 덮고 있는 얇고 매끄러운 작은 조각.
비닐	ㅂㅣㄴㅣㄹ	주로 포장에 사용되는 물건을 만드는 데 쓰는, 불에 잘 타지 않으며 물과 공기가 통하지 않는 질긴 물질.
비단	ㅂㅣㄷㅏㄴ	명주실로 짠, 광택이 나고 빛깔이 우아하며 가볍고 촉감이 부드러운 천.
비데	ㅂㅣㄷㅓㅣ	변기에 설치하여, 용변을 본 후 항문을 물로 씻는 데 쓰는 기구.
비듬	ㅂㅣㄷㅡㅁ	피부 표면, 특히 머리 부분이 굳어서 떨어져 나온 하얀 조각.
비련	ㅂㅣㄹㅕㄴ	그리움이나 사랑으로 인하여 느끼는 슬픔.
비례	ㅂㅣㄹㅕㅣ	한쪽의 수나 양이 변함에 따라 다른 쪽의 수나 양도 일정하게 변함.
비만	ㅂㅣㅁㅏㄴ	살이 쪄서 몸이 뚱뚱함.
비명	ㅂㅣㅁㅕㅇ	제명대로 살지 못하고 일찍 죽음.
비밀	ㅂㅣㅁㅣㄹ	숨기고 있어 남이 모르는 일.
비방	ㅂㅣㅂㅏㅇ	남에게 알려지지 않은 특별한 방법.
비법	ㅂㅣㅂㅓㅂ	남에게 알려지지 않은 특별한 방법.
비상	ㅂㅣㅅㅏㅇ	미리 생각하지 못 했던 위급한 일. 또는 이러한 일을 처리하기 위한 긴급한 명령.
비석	ㅂㅣㅅㅓㄱ	돌에 글자를 새겨서 세워 놓은 것.
비애	ㅂㅣㅇㅏㅣ	슬픔과 서러움.
비열	ㅂㅣㅇㅕㄹ	사람의 하는 짓이나 성품이 천하고 너그럽지 못하며 생각이 좁음.
비염	ㅂㅣㅇㅕㅁ	콧속에 염증이 생겨, 코가 막히고 콧물이 흐르며 재채기를 하는 병.
비옷	ㅂㅣㅇㅗㅅ	비에 젖지 않도록 옷 위에 덧입는, 물이 새지 않는 옷.
비용	ㅂㅣㅇㅛㅇ	어떤 일을 하는 데 드는 돈.
비운	ㅂㅣㅇㅜㄴ	탈 없이 잘 지내지 못하거나 슬픈 운수나 운명.
비위	ㅂㅣㅇㅜㅣ	어떤 음식을 먹고 싶어 하는 마음.
비율	ㅂㅣㅇㅠㄹ	기준이 되는 수나 양에 대한 어떤 값의 비.
비읍	ㅂㅣㅇㅡㅂ	한글 자모 ‘ㅂ’의 이름.
비장	ㅂㅣㅈㅏㅇ	다른 사람이 모르도록 숨기거나 감추어 소중히 간직함.
비전	ㅂㅣㅈㅓㄴ	앞으로 내다보이는 전망이나 계획.
비정	ㅂㅣㅈㅓㅇ	사람에게서 느껴지는 따뜻한 마음이 없이 차갑고 쌀쌀함.
비준	ㅂㅣㅈㅜㄴ	조약이 맺어지는 것에 대하여 대통령이나 국가가 최종적으로 확인하고 동의하는 것.
비중	ㅂㅣㅈㅜㅇ	다른 것과 비교했을 때 가지는 중요성의 정도.
비질	ㅂㅣㅈㅣㄹ	빗자루로 바닥 등을 쓰는 일.
비참	ㅂㅣㅊㅏㅁ	견딜 수 없을 정도로 슬프고 끔찍함.
비축	ㅂㅣㅊㅜㄱ	만약의 경우를 대비하여 미리 모아 둠.
비취	ㅂㅣㅊㅜㅣ	윤이 나고 반투명한 녹색의 보석.
비탄	ㅂㅣㅌㅏㄴ	매우 슬퍼하며 탄식함. 또는 그 탄식.
비탈	ㅂㅣㅌㅏㄹ	언덕, 길 등이 수평을 이루지 않고 기울어진 곳.
비통	ㅂㅣㅌㅗㅇ	매우 슬퍼서 마음이 아픔.
비판	ㅂㅣㅍㅏㄴ	무엇에 대해 자세히 따져 옳고 그름을 밝히거나 잘못된 점을 지적함.
비평	ㅂㅣㅍㅕㅇ	옳고 그름, 아름다움과 추함 등을 분석하여 사물의 가치를 논함.
비품	ㅂㅣㅍㅜㅁ	필요에 의해 늘 갖추어 놓고 쓰는 물품.
비화	ㅂㅣㅎㅗㅏ	세상에 알려지지 않은 이야기.
빈도	ㅂㅣㄴㄷㅗ	같은 일이나 현상이 나타나는 횟수.
빈부	ㅂㅣㄴㅂㅜ	가난함과 부유함.
빈사	ㅂㅣㄴㅅㅏ	거의 죽은 것과 같은 상태.
빈소	ㅂㅣㄴㅅㅗ	장례식장이나 상갓집에서 발인 전까지 관을 놓아 두는 곳.
빌미	ㅂㅣㄹㅁㅣ	좋지 않은 일이 생기거나 나쁜 상태에 놓이게 되는 원인이나 이유.
빙수	ㅂㅣㅇㅅㅜ	얼음을 잘게 갈고 그 위에 삶은 팥, 과일 등을 올린 음식.
빙어	ㅂㅣㅇㅇㅓ	15센티미터쯤 되는 몸은 연한 백색에 가늘고 편평하며 겨울 낚시로 유명한 바닷물고기.
빙자	ㅂㅣㅇㅈㅏ	무엇의 힘을 빌리거나 의지함.
빙하	ㅂㅣㅇㅎㅏ	추운 지역에서 눈이 오랫동안 쌓여 만들어진, 육지를 덮고 있는 큰 얼음덩어리.
뿌리	ㅂㅂㅜㄹㅣ	땅속으로 뻗어서 물과 양분을 빨아올리고 줄기를 지탱하는 식물의 한 부분.
삐라	ㅂㅂㅣㄹㅏ	→ 전단
사각	ㅅㅏㄱㅏㄱ	네 개의 각으로 이루어진 모양. 또는 그런 도형.
사건	ㅅㅏㄱㅓㄴ	관심이나 주목을 끌 만한 일.
사격	ㅅㅏㄱㅕㄱ	총을 쏨.
사견	ㅅㅏㄱㅕㄴ	자기의 개인적이고 주관적인 생각이나 의견.
사경	ㅅㅏㄱㅕㅇ	하룻밤을 다섯으로 나눈 오경의 넷째 부분으로, 새벽 한 시에서 세 시 사이.
사계	ㅅㅏㄱㅕㅣ	봄, 여름, 가을, 겨울의 네 계절.
사골	ㅅㅏㄱㅗㄹ	주로 몸의 기운을 보충하기 위해 고아 먹는 소의 다리뼈.
사공	ㅅㅏㄱㅗㅇ	배를 젓는 일을 직업으로 하는 사람.
사과	ㅅㅏㄱㅗㅏ	모양이 둥글고 붉으며 새콤하고 단맛이 나는 과일.
사극	ㅅㅏㄱㅡㄱ	역사에 있던 일이나 사람을 바탕으로 만든 연극이나 영화나 드라마.
사금	ㅅㅏㄱㅡㅁ	물가나 물속의 모래 또는 자갈에 섞여 있는 금 알갱이.
사내	ㅅㅏㄴㅏㅣ	혈기 왕성할 때의 젊은 남자.
사냥	ㅅㅏㄴㅑㅇ	사람이 산이나 들에 나가 총이나 활 등으로 짐승을 잡는 일.
사념	ㅅㅏㄴㅕㅁ	마음 속으로 하는 여러 가지 생각.
사단	ㅅㅏㄷㅏㄴ	어떤 목적을 위해 두 사람 이상이 함께 세운 단체.
사담	ㅅㅏㄷㅏㅁ	공적으로 하는 것이 아니라 개인적으로 이야기를 함. 또는 그런 이야기.
사당	ㅅㅏㄷㅏㅇ	조상의 이름을 적은 나무패를 모셔 두는 집.
사대	ㅅㅏㄷㅏㅣ	‘사범 대학’을 줄여 이르는 말.
사돈	ㅅㅏㄷㅗㄴ	혼인한 두 집안의 부모들 사이. 또는 혼인한 두 집안의 부모들이 서로 상대편을 부르거나 이르는 말.
사동	ㅅㅏㄷㅗㅇ	문장의 주체가 남에게 어떤 일이나 행동을 하도록 시키는 동사의 성질.
사둔	ㅅㅏㄷㅜㄴ	→ 사돈
사또	ㅅㅏㄷㄷㅗ	(옛날에) 백성이나 하급 관리가 자기 고을을 다스리는 최고 관리를 부르던 말.
사람	ㅅㅏㄹㅏㅁ	생각할 수 있으며 언어와 도구를 만들어 사용하고 사회를 이루어 사는 존재.
사랑	ㅅㅏㄹㅏㅇ	상대에게 성적으로 매력을 느껴 열렬히 좋아하는 마음.
사력	ㅅㅏㄹㅕㄱ	죽을 각오를 하고 최선을 다하여 쓰는 힘.
사례	ㅅㅏㄹㅕㅣ	이전에 실제로 일어난 예.
사립	ㅅㅏㄹㅣㅂ	개인이 자신의 자금으로 공공의 이익을 위한 사업 기관을 설립하여 유지함.
사막	ㅅㅏㅁㅏㄱ	비가 아주 적게 내려서 동식물이 거의 살지 않고 모래로 뒤덮인 땅.
사망	ㅅㅏㅁㅏㅇ	사람이 죽음.
사면	ㅅㅏㅁㅕㄴ	앞과 뒤, 왼쪽과 오른쪽의 모든 방향.
사멸	ㅅㅏㅁㅕㄹ	죽어서 없어짐.
사명	ㅅㅏㅁㅕㅇ	맡겨진 일.
사물	ㅅㅏㅁㅜㄹ	직접 보거나 만질 수 있게 일정한 모양과 성질을 갖추고 있는, 세상의 온갖 물건.
사발	ㅅㅏㅂㅏㄹ	위는 넓고 아래는 좁으며 굽이 있는 사기 그릇.
사방	ㅅㅏㅂㅏㅇ	동, 서, 남, 북의 네 가지 방향.
사범	ㅅㅏㅂㅓㅁ	법적인 처벌을 받을 만한 행위. 또는 그런 행위를 한 사람.
사법	ㅅㅏㅂㅓㅂ	국가나 국민에 관한 일을 법에 따라 판단하는 국가의 기본적인 활동.
사변	ㅅㅏㅂㅕㄴ	사람의 힘으로는 피할 수 없는 자연 재해나 그 밖의 큰 사건.
사별	ㅅㅏㅂㅕㄹ	가족 구성원 중 한 쪽이 먼저 죽어서 헤어짐.
사병	ㅅㅏㅂㅕㅇ	군대에서, 장교가 아닌 보통 군인.
사복	ㅅㅏㅂㅗㄱ	제복이 아닌 평상시에 입는 보통 옷.
사본	ㅅㅏㅂㅗㄴ	원본을 복사하거나 베껴 놓은 서류나 책.
사산	ㅅㅏㅅㅏㄴ	임신한 지 사 개월이 지난 후 죽은 아이를 낳음.
사살	ㅅㅏㅅㅏㄹ	활이나 총 등으로 쏘아 죽임.
사상	ㅅㅏㅅㅏㅇ	역사가 기록되어 온 이래.
사석	ㅅㅏㅅㅓㄱ	개인적으로 만나는 자리.
사선	ㅅㅏㅅㅓㄴ	죽을 고비.
사설	ㅅㅏㅅㅓㄹ	개인의 의견.
사슬	ㅅㅏㅅㅡㄹ	쇠로 만든 고리를 이어서 만든 줄.
사슴	ㅅㅏㅅㅡㅁ	눈망울이 크고 털은 갈색이며 다리가 길고 수컷의 머리에는 뿔이 있는 산짐승.
사식	ㅅㅏㅅㅣㄱ	교도소나 유치장에 갇힌 사람에게 외부에서 개인적으로 마련하여 주는 음식.
사신	ㅅㅏㅅㅣㄴ	(옛날에) 임금이나 나라의 명령을 받고 다른 나라에 파견되는 신하.
사실	ㅅㅏㅅㅣㄹ	실제로 있었던 일이나 현재 일어나고 있는 일.
사심	ㅅㅏㅅㅣㅁ	개인적이고 사사로운 마음. 또는 자기의 욕심을 채우려는 마음.
사안	ㅅㅏㅇㅏㄴ	법률, 규정 등으로 문제가 되는 일의 안건.
사약	ㅅㅏㅇㅑㄱ	먹으면 죽는 약.
사양	ㅅㅏㅇㅑㅇ	저녁때의 햇빛. 또는 저녁때의 지는 해.
사업	ㅅㅏㅇㅓㅂ	경제적 이익을 얻기 위하여 어떤 조직을 경영하는 일.
사역	ㅅㅏㅇㅕㄱ	다른 사람에게 일을 시킴. 또는 시킴을 받아 일을 함.
사연	ㅅㅏㅇㅕㄴ	일어난 일의 앞뒤 사정과 까닭.
사열	ㅅㅏㅇㅕㄹ	조사하거나 검열하기 위하여 하나씩 살펴봄.
사옥	ㅅㅏㅇㅗㄱ	회사가 있는 건물.
사외	ㅅㅏㅇㅗㅣ	회사의 밖. 또는 회사의 직원이나 관계자가 아닌 사람.
사욕	ㅅㅏㅇㅛㄱ	자신의 개인적인 이익만을 채우려는 욕심.
사용	ㅅㅏㅇㅛㅇ	무엇을 필요한 일이나 기능에 맞게 씀.
사위	ㅅㅏㅇㅜㅣ	딸의 남편.
사육	ㅅㅏㅇㅠㄱ	가축이나 짐승을 먹이고 돌보아 기름.
사은	ㅅㅏㅇㅡㄴ	받은 은혜에 감사하여 선물 등으로 감사를 표현함.
사의	ㅅㅏㅇㅡㅣ	감사하게 여기는 마음이나 뜻.
사익	ㅅㅏㅇㅣㄱ	개인의 이익.
사인	ㅅㅏㅇㅣㄴ	죽게 된 원인.
사임	ㅅㅏㅇㅣㅁ	맡고 있던 일자리를 스스로 그만둠.
사장	ㅅㅏㅈㅏㅇ	회사를 대표하고 회사의 일을 책임지는 사람.
사재	ㅅㅏㅈㅏㅣ	개인이 가지고 있는 재산.
사적	ㅅㅏㅈㅓㄱ	개인에 관계된 것.
사전	ㅅㅏㅈㅓㄴ	일이 일어나기 전. 또는 일을 시작하기 전.
사절	ㅅㅏㅈㅓㄹ	나라를 대표하여 어떤 일을 맡고 다른 나라에 가는 사람.
사정	ㅅㅏㅈㅓㅇ	일의 형편이나 이유.
사제	ㅅㅏㅈㅓㅣ	공적인 일과 관계없이 개인이 만듦. 또는 그런 물건.
사족	ㅅㅏㅈㅗㄱ	짐승의 네 발.
사죄	ㅅㅏㅈㅗㅣ	지은 죄나 잘못에 대해 용서를 구함.
사죽	ㅅㅏㅈㅜㄱ	→ 사족 1
사직	ㅅㅏㅈㅣㄱ	나라 또는 나라의 정치가 이루어지는 곳.
사진	ㅅㅏㅈㅣㄴ	사물의 모습을 오래 보존할 수 있도록 사진기로 찍어 종이나 컴퓨터 등에 나타낸 영상.
사찰	ㅅㅏㅊㅏㄹ	스님들이 불상을 모시고 불교를 가르치고 배우며 도를 닦는 곳.
사채	ㅅㅏㅊㅏㅣ	금융 기관이 아니라 개인에게 돈을 빌려 진 빚.
사철	ㅅㅏㅊㅓㄹ	봄, 여름, 가을, 겨울의 네 계절.
사체	ㅅㅏㅊㅓㅣ	사람이나 동물의 죽은 몸.
사촌	ㅅㅏㅊㅗㄴ	부모님의 친형제자매의 아들이나 딸과의 친족 관계. 또는 그런 관계에 있는 사람.
사칭	ㅅㅏㅊㅣㅇ	이름, 직업, 나이, 주소 등을 거짓으로 속여 말함.
사탄	ㅅㅏㅌㅏㄴ	적대자라는 뜻으로, 하느님에게 맞서는 나쁜 무리의 우두머리.
사탕	ㅅㅏㅌㅏㅇ	엿이나 설탕을 졸여서 입에 넣기 좋은 크기로 만든 딱딱하고 단 과자.
사태	ㅅㅏㅌㅏㅣ	산이나 언덕의 흙 또는 쌓인 눈 등이 비바람 같은 충격을 받아 한꺼번에 무너져 내리는 일.
사퇴	ㅅㅏㅌㅗㅣ	어떤 직위나 직책을 그만두고 물러남.
사학	ㅅㅏㅎㅏㄱ	남아 있는 자료를 통해 과거의 사람들이 살던 모습을 연구하는 학문.
사항	ㅅㅏㅎㅏㅇ	어떤 일이나 사실을 이루는 항목 또는 내용.
사해	ㅅㅏㅎㅏㅣ	동서남북 네 방향의 바다.
사형	ㅅㅏㅎㅕㅇ	죄인의 목숨을 끊음. 또는 그 형벌.
사회	ㅅㅏㅎㅗㅣ	회의, 대회, 의식 등의 행사를 진행함.
사흘	ㅅㅏㅎㅡㄹ	세 날.
산고	ㅅㅏㄴㄱㅗ	아이를 낳을 때 겪는 고통.
산기	ㅅㅏㄴㄱㅣ	임신부가 아이를 낳으려는 기미.
산모	ㅅㅏㄴㅁㅗ	아이를 낳은 지 얼마 되지 않은 여자.
산보	ㅅㅏㄴㅂㅗ	바람을 쐬거나 가벼운 운동을 하기 위해 멀지 않은 거리를 천천히 걷는 것.
산사	ㅅㅏㄴㅅㅏ	산속에 있는 절.
산소	ㅅㅏㄴㅅㅗ	(높이는 말로) 사람의 무덤.
산수	ㅅㅏㄴㅅㅜ	산과 물이 있는 자연의 경치.
산지	ㅅㅏㄴㅈㅣ	어떤 상품이 생산되는 지역.
산타	ㅅㅏㄴㅌㅏ	흰 수염에 붉은 색 옷을 입고 성탄절 전날 밤에 아이들에게 선물을 준다고 알려진 할아버지.
산파	ㅅㅏㄴㅍㅏ	산모가 아기를 잘 낳을 수 있도록 도와주며 아기 받는 일을 하는 여자.
산하	ㅅㅏㄴㅎㅏ	산과 강 등의 모든 자연.
산호	ㅅㅏㄴㅎㅗ	죽어서 남긴 뼈가 장신구의 재료로 사용되는, 따뜻하고 얕은 바다 밑에 사는 나뭇가지 모양의 동물.
산후	ㅅㅏㄴㅎㅜ	아이를 낳은 뒤.
살구	ㅅㅏㄹㄱㅜ	이른 여름에 열리며 시고 단 맛이 나는, 붉은빛을 띤 노란색의 둥글고 작은 과일.
살기	ㅅㅏㄹㄱㅣ	독하고 무서운 기운이나 분위기.
살사	ㅅㅏㄹㅅㅏ	쿠바의 리듬에 로큰롤, 재즈 등을 혼합한 라틴 음악.
살포	ㅅㅏㄹㅍㅗ	액체나 가루, 가스 등을 뿌림.
삼루	ㅅㅏㅁㄹㅜ	야구에서, 이루와 포수가 있는 본루 사이에 있는 셋째 누.
삼류	ㅅㅏㅁㄹㅠ	어떤 분야에서 수준이나 지위가 가장 낮은 부류.
삼수	ㅅㅏㅁㅅㅜ	주로 대학 입학시험에서 두 번 떨어지고 세 번째 시험을 준비하는 것.
삼시	ㅅㅏㅁㅅㅣ	아침, 점심, 저녁으로 하루에 세 번 먹는 끼니. 또는 그 끼니때.
삼자	ㅅㅏㅁㅈㅏ	어떤 일에 직접 관계가 없는 사람.
삼치	ㅅㅏㅁㅊㅣ	고등어보다 조금 더 크고 청색의 등에는 푸른 갈색의 얼룩무늬가 있는 바닷물고기.
상가	ㅅㅏㅇㄱㅏ	물건을 파는 가게가 모여 있는 건물.
상고	ㅅㅏㅇㄱㅗ	법원의 첫 판결을 따르지 않고 두 번째로 판결을 받은 다음, 그 역시 따를 수 없어 상급 법원에 다시 판결해 줄 것을 신청함.
상기	ㅅㅏㅇㄱㅣ	한 편의 글에서, 앞이나 위에 적은 것.
상류	ㅅㅏㅇㄹㅠ	흐르는 강이나 냇물의 윗부분.
상보	ㅅㅏㅇㅂㅗ	음식을 차려 놓은 상 위에 먼지나 파리 등이 앉지 않도록 덮어 놓는 보자기.
상사	ㅅㅏㅇㅅㅏ	군대에서 원사의 아래, 중사의 위인 계급. 또는 그 계급인 군인.
상소	ㅅㅏㅇㅅㅗ	어떤 사연이나 의견을 글로 적어 임금에게 올리던 일. 또는 그 글.
상수	ㅅㅏㅇㅅㅜ	마시거나 사용할 목적으로 수도관을 통해 보내는 맑은 물.
상시	ㅅㅏㅇㅅㅣ	일상적으로 늘.
상아	ㅅㅏㅇㅇㅏ	코끼리의 입 밖으로 길고 날카롭게 뻗어 있는 두 개의 앞니.
상어	ㅅㅏㅇㅇㅓ	지느러미가 크고 날카로운 이를 가졌으며, 성질이 매우 사납고 무엇이든 잡아먹는 바다에 사는 물고기.
상여	ㅅㅏㅇㅇㅕ	사람의 시체를 묘지까지 실어 나르는 데 쓰는 도구.
상자	ㅅㅏㅇㅈㅏ	물건을 넣어 둘 수 있도록 나무나 종이 등으로 만든 네모난 통.
상주	ㅅㅏㅇㅈㅜ	한곳에 계속 머물러 있음.
상처	ㅅㅏㅇㅊㅓ	아내가 죽는 일을 당함.
상추	ㅅㅏㅇㅊㅜ	잎이 쭈글쭈글하고 넓은, 주로 쌈을 사서 먹는 녹색 채소.
상치	ㅅㅏㅇㅊㅣ	→ 상추
상투	ㅅㅏㅇㅌㅜ	(옛날에) 성인 남자가 머리털을 머리 위에 하나로 뭉쳐서 감아 맨 것.
상표	ㅅㅏㅇㅍㅛ	상품을 만든 회사를 나타내는 기호나 그림 등의 표시.
상하	ㅅㅏㅇㅎㅏ	위와 아래.
상호	ㅅㅏㅇㅎㅗ	짝을 이루거나 관계를 맺고 있는 이쪽과 저쪽 모두.
샅바	ㅅㅏㅌㅂㅏ	씨름에서, 허리와 다리에 둘러 묶어서 손잡이로 쓰는 띠.
새우	ㅅㅏㅣㅇㅜ	등이 굽어 있으며 수염이 길고 발이 여러 개 있는, 물에 사는 작은 동물.
새치	ㅅㅏㅣㅊㅣ	젊은 사람의 검은 머리에 조금 섞여서 난 흰 머리카락.
샤워	ㅅㅑㅇㅜㅓ	비처럼 물을 뿜어내는 기구로 몸을 씻음.
샴푸	ㅅㅑㅁㅍㅜ	머리를 감는 데 쓰는 액체 비누.
서곡	ㅅㅓㄱㅗㄱ	오페라나 종교 음악 등의 첫머리에 연주되는 음악.
서남	ㅅㅓㄴㅏㅁ	서쪽과 남쪽.
서녘	ㅅㅓㄴㅕㅋ	서쪽 방향.
서당	ㅅㅓㄷㅏㅇ	(옛날에) 아이들이 글을 배우던 곳.
서랍	ㅅㅓㄹㅏㅂ	책상이나 옷장 등에 끼웠다 뺐다 하게 만든, 물건을 담는 상자.
서론	ㅅㅓㄹㅗㄴ	말이나 글에서 본격적인 논의를 하기 위한 첫머리가 되는 부분.
서막	ㅅㅓㅁㅏㄱ	연극 등에서, 인물과 사건 등을 예비적으로 보여 주는, 처음을 여는 막.
서면	ㅅㅓㅁㅕㄴ	일정한 내용을 적은 문서.
서명	ㅅㅓㅁㅕㅇ	어떤 내용을 받아들이는 뜻으로 자기의 이름을 씀. 또는 그 이름.
서문	ㅅㅓㅁㅜㄴ	서쪽으로 난 문.
서민	ㅅㅓㅁㅣㄴ	특별히 높은 신분을 가지지 않은 일반 사람.
서방	ㅅㅓㅂㅏㅇ	동서남북 중 서의 방향.
서법	ㅅㅓㅂㅓㅂ	글씨를 쓰는 법.
서북	ㅅㅓㅂㅜㄱ	서쪽과 북쪽. 또는 서쪽과 북쪽의 사이 방위.
서설	ㅅㅓㅅㅓㄹ	본론 전에 쓴 대강의 서론적인 해설.
서술	ㅅㅓㅅㅜㄹ	어떤 사실, 사건, 생각 등을 논리나 순서에 따라 말하거나 적음.
서슬	ㅅㅓㅅㅡㄹ	쇠붙이로 만든 연장이나 유리 조각 등의 날카로운 끝부분.
서식	ㅅㅓㅅㅣㄱ	일정한 형식을 갖춘 서류를 쓰는 방식.
서신	ㅅㅓㅅㅣㄴ	다른 사람에게 하고 싶은 말을 적어서 보내는 글.
서실	ㅅㅓㅅㅣㄹ	책을 갖추어 두고 책을 읽거나 글을 쓰는 방.
서약	ㅅㅓㅇㅑㄱ	맹세하고 약속함.
서양	ㅅㅓㅇㅑㅇ	유럽과 아메리카 지역.
서열	ㅅㅓㅇㅕㄹ	가치나 지위의 높고 낮음에 따라 순서대로 늘어섬. 또는 그 순서.
서예	ㅅㅓㅇㅕㅣ	붓으로 글씨를 쓰는 예술.
서울	ㅅㅓㅇㅜㄹ	한 나라의 중앙 정부가 있는 곳.
서장	ㅅㅓㅈㅏㅇ	경찰서, 세무서, 소방서 등과 같이 ‘서’로 끝나는 기관을 대표하고 책임지는 사람.
서재	ㅅㅓㅈㅏㅣ	책을 갖추어 두고 책을 읽거나 글을 쓰는 방.
서적	ㅅㅓㅈㅓㄱ	글이나 그림 등을 인쇄하여 묶어 놓은 것.
서점	ㅅㅓㅈㅓㅁ	책을 파는 가게.
서찰	ㅅㅓㅊㅏㄹ	다른 사람에게 하고 싶은 말을 적어서 보내는 글.
서체	ㅅㅓㅊㅓㅣ	손으로 직접 쓴 글씨의 모양.
서클	ㅅㅓㅋㅡㄹ	같은 취미를 가진 사람들의 모임.
서편	ㅅㅓㅍㅕㄴ	서쪽 방향.
서평	ㅅㅓㅍㅕㅇ	책의 내용에 대해 좋고 나쁨, 잘하고 못함 등을 평가하는 글.
서푼	ㅅㅓㅍㅜㄴ	아주 보잘것없는 값.
서풍	ㅅㅓㅍㅜㅇ	서쪽에서 불어오는 바람.
서한	ㅅㅓㅎㅏㄴ	다른 사람에게 하고 싶은 말을 적어서 보내는 글.
서해	ㅅㅓㅎㅏㅣ	서쪽에 있는 바다.
서향	ㅅㅓㅎㅑㅇ	서쪽으로 향함. 또는 서쪽 방향.
서화	ㅅㅓㅎㅗㅏ	주로 붓으로 쓴 글씨와 붓으로 그린 그림.
석가	ㅅㅓㄱㄱㅏ	불교의 창시자(기원전 ?~기원전 ?). 네팔의 한 지방에서 태어났고 29세에 출가하여 35세에 보리수 아래에서 깨달음을 얻어 부처가 되었다고 한다. 인도 각지를 다니며 가르침을 전하다가 80세에 죽었다.
석기	ㅅㅓㄱㄱㅣ	주로 원시인이 쓰던, 돌로 만든 여러 가지 생활 도구.
석류	ㅅㅓㄱㄹㅠ	높이는 3미터 정도이며 잎은 긴 타원형으로 마주 붙어 나고, 늦봄에 붉은 꽃이 핀 후 10월에 빨갛고 둥근 열매가 익는 나무.
석사	ㅅㅓㄱㅅㅏ	대학원을 졸업한 사람에게 주는 학위. 또는 그 학위를 받은 사람.
석수	ㅅㅓㄱㅅㅜ	돌로 물건을 만드는 사람.
석유	ㅅㅓㄱㅇㅠ	땅속에서 천연으로 나며 태워서 에너지를 만드는, 주로 자동차나 공장의 연료로 쓰는 검은색의 기름.
석조	ㅅㅓㄱㅈㅗ	돌로 물건을 만드는 일. 또는 그 물건.
석차	ㅅㅓㄱㅊㅏ	성적에 의한 순서.
선거	ㅅㅓㄴㄱㅓ	일정한 조직이나 집단에서 투표를 통해 대표자나 임원을 뽑음.
선고	ㅅㅓㄴㄱㅗ	어떤 결정이나 사실을 선언하여 알림.
선교	ㅅㅓㄴㄱㅛ	종교를 널리 전하여 퍼뜨림.
선녀	ㅅㅓㄴㄴㅕ	옛날이야기에서, 신선 세계에 산다고 하는 여자.
선도	ㅅㅓㄴㄷㅗ	앞장서서 이끎.
선두	ㅅㅓㄴㄷㅜ	줄이나 행렬, 활동 등에서 맨 앞. 또는 맨 앞에 서는 사람.
선로	ㅅㅓㄴㄹㅗ	기차나 전차 등이 다닐 수 있도록 만들어 놓은 길.
선비	ㅅㅓㄴㅂㅣ	(옛날에) 학문을 배우고 익힌 사람.
선사	ㅅㅓㄴㅅㅏ	문자로 된 기록이 없는, 역사 시대 이전의 옛 시대.
선서	ㅅㅓㄴㅅㅓ	여러 사람 앞에서 공식적으로 무엇을 인정하거나 지키겠다고 다짐하여 말함.
선수	ㅅㅓㄴㅅㅜ	남이 하기 전에 먼저 하는 행동.
선조	ㅅㅓㄴㅈㅗ	먼 윗대의 조상.
선주	ㅅㅓㄴㅈㅜ	배의 주인.
선지	ㅅㅓㄴㅈㅣ	돼지나 소 등의 짐승을 잡아서 받은 피.
선처	ㅅㅓㄴㅊㅓ	어떤 문제를 형편에 맞도록 너그럽게 잘 처리함.
선포	ㅅㅓㄴㅍㅗ	어떤 사실이나 내용을 공식적으로 세상에 널리 알림.
선호	ㅅㅓㄴㅎㅗ	여럿 가운데서 어떤 것을 특별히 더 좋아함.
선후	ㅅㅓㄴㅎㅜ	어떤 것의 먼저와 나중.
설교	ㅅㅓㄹㄱㅛ	주로 기독교에서, 목사가 기독교의 교리를 설명함. 또는 그 설명.
설비	ㅅㅓㄹㅂㅣ	필요한 물건이나 시설을 갖춤. 또는 그런 시설.
설사	ㅅㅓㄹㅅㅏ	장에서 음식물을 소화하는 데에 이상이 생겨 물기가 많은 똥을 눔. 또는 그런 똥.
설치	ㅅㅓㄹㅊㅣ	어떤 목적에 맞게 쓰기 위하여 기관이나 설비 등을 만들거나 제자리에 맞게 놓음.
설파	ㅅㅓㄹㅍㅏ	듣는 사람이 이해하도록 어떤 내용이나 주장을 강하고 분명하게 밝혀 말함.
섬유	ㅅㅓㅁㅇㅠ	주로 천이나 의류 등의 재료가 되는, 생물체의 몸을 이루는 가늘고 긴 실 모양의 물질.
섭리	ㅅㅓㅂㄹㅣ	자연계를 다스리고 있는 원리.
성가	ㅅㅓㅇㄱㅏ	기독교나 가톨릭에서 부르는 종교적인 노래.
성교	ㅅㅓㅇㄱㅛ	남자와 여자가 성기를 통하여 육체적으로 관계를 맺음.
성기	ㅅㅓㅇㄱㅣ	생물이 새끼를 배거나 씨를 맺는 등의 생식을 하는 데 쓰는 몸의 기관.
성녀	ㅅㅓㅇㄴㅕ	지혜와 덕이 뛰어난 여자.
성도	ㅅㅓㅇㄷㅗ	(높이는 말로) 기독교 신자.
성묘	ㅅㅓㅇㅁㅛ	조상의 산소에 가서 인사를 드리고 산소를 돌봄. 또는 그런 일.
성미	ㅅㅓㅇㅁㅣ	개인의 성격, 버릇, 마음가짐 등.
성비	ㅅㅓㅇㅂㅣ	한 집단에서, 남녀 또는 암수의 비율.
성사	ㅅㅓㅇㅅㅏ	뜻한 대로 일이 이루어짐. 또는 일을 이룸.
성서	ㅅㅓㅇㅅㅓ	기독교의 기본 원리와 가르침을 적은 책.
성우	ㅅㅓㅇㅇㅜ	방송이나 영화에 직접 출연하지 않고 등장인물의 목소리만 대신 내며 연기하는 배우.
성자	ㅅㅓㅇㅈㅏ	지혜와 인격이 뛰어나 많은 사람들이 본받을 만한 사람.
성조	ㅅㅓㅇㅈㅗ	음절 안에서 나타나는 소리의 높낮이.
성주	ㅅㅓㅇㅈㅜ	성의 우두머리.
성지	ㅅㅓㅇㅈㅣ	그 종교가 처음으로 생겨난 곳과 같이 특정 종교에서 신성하게 여기는 장소.
성터	ㅅㅓㅇㅌㅓ	성이 있었던 자리.
성토	ㅅㅓㅇㅌㅗ	여러 사람이 모여 국가나 사회에 끼친 잘못을 소리 높여 따지고 나무람.
성호	ㅅㅓㅇㅎㅗ	가톨릭에서, 거룩한 표라는 뜻으로 신자가 손으로 가슴에 긋는 십자가.
세기	ㅅㅓㅣㄱㅣ	백 년을 단위로 하는 기간.
세도	ㅅㅓㅣㄷㅗ	정치적인 지위나 권력. 또는 그 권력을 마구 휘두르는 일.
세로	ㅅㅓㅣㄹㅗ	위에서 아래로 이어지는 방향. 또는 그 길이.
세모	ㅅㅓㅣㅁㅗ	선과 선이 만나는 세 개의 모.
세부	ㅅㅓㅣㅂㅜ	자세한 부분.
세비	ㅅㅓㅣㅂㅣ	국가 기관에서 한 해 동안 쓰는 비용.
세수	ㅅㅓㅣㅅㅜ	물로 손이나 얼굴을 씻음.
세시	ㅅㅓㅣㅅㅣ	한 해의 여러 절기나 달, 계절에 따른 때.
세자	ㅅㅓㅣㅈㅏ	왕의 자리를 이어서 다음 왕이 될 왕자.
세차	ㅅㅓㅣㅊㅏ	자동차의 안을 청소하거나 바깥에 묻은 먼지나 흙 등을 씻음.
세트	ㅅㅓㅣㅌㅡ	가구나 도구, 그릇 등의 물건이 서로 어울리도록 같이 만들어진 것.
세파	ㅅㅓㅣㅍㅏ	세상살이의 어려움.
세포	ㅅㅓㅣㅍㅗ	생물체를 이루는 기본 단위.
세후	ㅅㅓㅣㅎㅜ	세금을 낸 후.
소각	ㅅㅗㄱㅏㄱ	불에 태워 없앰.
소감	ㅅㅗㄱㅏㅁ	어떤 일에 대하여 느끼고 생각한 것.
소개	ㅅㅗㄱㅏㅣ	둘 사이에서 양쪽의 일이 잘 진행되게 힘씀.
소견	ㅅㅗㄱㅕㄴ	어떤 일이나 사물을 보고 느낀 생각이나 의견.
소경	ㅅㅗㄱㅕㅇ	(낮잡아 이르는 말로) 시각 장애인.
소계	ㅅㅗㄱㅕㅣ	전체가 아닌 어느 한 부분만을 더한 합계.
소굴	ㅅㅗㄱㅜㄹ	나쁜 짓을 하는 무리가 모여 있는 본거지.
소금	ㅅㅗㄱㅡㅁ	짠맛을 내는 하얀 가루.
소급	ㅅㅗㄱㅡㅂ	현재의 어떤 사실에 대한 생각이나 법, 규정의 효력을 과거의 어느 때에도 적용되게 함.
소년	ㅅㅗㄴㅕㄴ	아직 어른이 되지 않은 어린 남자아이.
소뇌	ㅅㅗㄴㅗㅣ	주로 운동 기능과 평형 감각을 조절하는, 대뇌의 아래에 위치하는 작은 뇌.
소대	ㅅㅗㄷㅏㅣ	분대의 위, 중대의 아래인 군대 조직.
소독	ㅅㅗㄷㅗㄱ	병에 걸리는 것을 막기 위해 약품이나 열 등으로 균을 죽임.
소동	ㅅㅗㄷㅗㅇ	시끄럽게 떠들고 어지럽게 행동하는 일.
소득	ㅅㅗㄷㅡㄱ	어떤 일의 결과로 얻는 이익.
소등	ㅅㅗㄷㅡㅇ	공공장소나 건물 등의 등불을 끔.
소띠	ㅅㅗㄷㄷㅣ	소해에 태어난 사람의 띠.
소란	ㅅㅗㄹㅏㄴ	시끄럽고 정신없게 복잡함.
소량	ㅅㅗㄹㅑㅇ	적은 양.
소련	ㅅㅗㄹㅕㄴ	1922년부터 1991년까지 유라시아 대륙의 북부에 있었던 최초의 사회주의 연방 국가. 동유럽에 막강한 영향력을 행사하였으나 1991년 사회주의가 붕괴되면서 연방이 해체되었다. 정식 명칭은 '소비에트 사회주의 공화국 연방'이다.
소령	ㅅㅗㄹㅕㅇ	군대에서 중령의 아래이며 대위의 위인 계급. 또는 그 계급에 있는 군인.
소론	ㅅㅗㄹㅗㄴ	주제가 크지 않고 길이가 길지 않은 논설이나 논문.
소름	ㅅㅗㄹㅡㅁ	무섭거나 춥거나 징그러울 때 피부가 오므라들며 좁쌀 같은 것이 돋는 것.
소만	ㅅㅗㅁㅏㄴ	만물이 점차 생장하여 가득 찬다는 때로 이십사절기의 하나. 5월 21일경이다. 본격적으로 여름이 되어 모내기가 시작되고 보리 베기와 잡초 제거로 바쁜 시기이다.
소망	ㅅㅗㅁㅏㅇ	어떤 일을 바람. 또는 바라는 그 일.
소매	ㅅㅗㅁㅏㅣ	윗옷의 양 팔을 덮는 부분.
소멸	ㅅㅗㅁㅕㄹ	사라져 없어짐.
소명	ㅅㅗㅁㅕㅇ	어떤 일에 대해 책임을 맡으라고 하는 사회적 요청.
소문	ㅅㅗㅁㅜㄴ	사람들 사이에 널리 퍼진 말이나 소식.
소박	ㅅㅗㅂㅏㄱ	아내나 첩을 정성을 들이지 않고 아무렇게나 대함.
소반	ㅅㅗㅂㅏㄴ	크기가 작은 밥상.
소방	ㅅㅗㅂㅏㅇ	화재를 막거나 진압함.
소변	ㅅㅗㅂㅕㄴ	(점잖게 이르는 말로) 사람의 오줌.
소복	ㅅㅗㅂㅗㄱ	흔히 상복으로 입는, 하얗게 차려 입은 옷.
소산	ㅅㅗㅅㅏㄴ	어떤 지역에서 생산되는 물건.
소설	ㅅㅗㅅㅓㄹ	눈이 내리기 시작한다는 날로 이십사절기의 하나. 11월 22일경이다.
소속	ㅅㅗㅅㅗㄱ	어떤 기관이나 단체에 속함. 또는 속해 있는 사람이나 물건.
소송	ㅅㅗㅅㅗㅇ	사람들 사이에 일어난 다툼을 법률에 따라 판결해 달라고 법원에 요구함.
소식	ㅅㅗㅅㅣㄱ	음식을 적게 먹음.
소신	ㅅㅗㅅㅣㄴ	굳게 믿는 생각.
소실	ㅅㅗㅅㅣㄹ	사라져 없어지거나 잃어버림.
소양	ㅅㅗㅇㅑㅇ	평소에 쌓아 둔 학문이나 지식.
소외	ㅅㅗㅇㅗㅣ	어떤 무리에서 멀리하거나 따돌림.
소용	ㅅㅗㅇㅛㅇ	어떤 이익이나 쓸모.
소위	ㅅㅗㅇㅜㅣ	군대에서 중위의 아래이며 준위의 위인 계급. 또는 그 계급에 있는 군인.
소음	ㅅㅗㅇㅡㅁ	불쾌하고 시끄러운 소리.
소인	ㅅㅗㅇㅣㄴ	나이가 어린 사람.
소일	ㅅㅗㅇㅣㄹ	별로 하는 일 없이 세월을 보냄.
소임	ㅅㅗㅇㅣㅁ	맡은 일이나 책임.
소작	ㅅㅗㅈㅏㄱ	땅을 갖지 못한 농민이 일정한 돈을 내고 다른 사람의 땅을 빌려서 농사를 짓는 일.
소장	ㅅㅗㅈㅏㅇ	위와 큰창자 사이에 있는 기관.
소재	ㅅㅗㅈㅏㅣ	어떤 곳에 있음. 또는 있는 곳.
소절	ㅅㅗㅈㅓㄹ	말, 글, 노래 등을 일정하게 나눈 부분.
소정	ㅅㅗㅈㅓㅇ	정해진 바.
소제	ㅅㅗㅈㅓㅣ	더럽고 지저분한 것을 깨끗하게 치움.
소진	ㅅㅗㅈㅣㄴ	점점 줄어들어 다 없어짐. 또는 다 써서 없앰.
소질	ㅅㅗㅈㅣㄹ	태어날 때부터 지니고 있는 능력이나 성질.
소집	ㅅㅗㅈㅣㅂ	단체나 조직에 속한 사람들을 불러 모음.
소철	ㅅㅗㅊㅓㄹ	가지가 없고 줄기 끝에서 깃털처럼 생긴 큰 잎이 여러 방향으로 뻗쳐 나는 나무.
소청	ㅅㅗㅊㅓㅇ	다른 사람에게 부탁하거나 바라는 일.
소총	ㅅㅗㅊㅗㅇ	개인이 들고 다닐 수 있게 만든 총.
소출	ㅅㅗㅊㅜㄹ	논밭에서 나는 곡식. 또는 일정한 논밭에서 나는 곡식의 양.
소탕	ㅅㅗㅌㅏㅇ	모조리 잡거나 없애 버림.
소태	ㅅㅗㅌㅏㅣ	아주 짠 맛. 또는 아주 짠 음식.
소통	ㅅㅗㅌㅗㅇ	막히지 않고 서로 잘 통함.
소폭	ㅅㅗㅍㅗㄱ	좁은 범위나 적은 정도.
소품	ㅅㅗㅍㅜㅁ	크기가 작은 미술 작품 또는 길이가 짧은 문학이나 음악 작품.
소풍	ㅅㅗㅍㅜㅇ	경치를 즐기거나 놀이를 하기 위하여 야외에 나갔다 오는 일.
소한	ㅅㅗㅎㅏㄴ	본격적으로 추워지는 때로 이십사절기의 하나. 1월 5일경이다. 한국에서는 일 년 중 이 시기에 가장 춥다.
소형	ㅅㅗㅎㅕㅇ	같은 종류의 사물 가운데 크기나 규모가 작은 것.
소홀	ㅅㅗㅎㅗㄹ	중요하게 생각하지 않아 주의나 정성이 부족함.
소화	ㅅㅗㅎㅗㅏ	먹은 음식물을 뱃속에서 분해하여 영양분으로 흡수함.
소회	ㅅㅗㅎㅗㅣ	마음에 품고 있는 느낌이나 생각.
속기	ㅅㅗㄱㄱㅣ	빨리 적음.
속도	ㅅㅗㄱㄷㅗ	물체가 움직이거나 일이 진행되는 빠르기.
속보	ㅅㅗㄱㅂㅗ	빨리 걸음. 또는 빠른 걸음.
속어	ㅅㅗㄱㅇㅓ	일반 사람들이 널리 쓰는, 품위 없는 말.
손녀	ㅅㅗㄴㄴㅕ	아들의 딸. 또는 딸의 딸.
손자	ㅅㅗㄴㅈㅏ	아들의 아들. 또는 딸의 아들.
손주	ㅅㅗㄴㅈㅜ	손자와 손녀.
솔가	ㅅㅗㄹㄱㅏ	집안 식구 전부를 데리고 가거나 옴.
솔기	ㅅㅗㄹㄱㅣ	옷이나 이불 등을 만들 때 두 쪽을 마주 대고 꿰맨 줄.
솔로	ㅅㅗㄹㄹㅗ	혼자 노래하거나 연주하는 일.
송가	ㅅㅗㅇㄱㅏ	공덕을 기리는 노래.
송고	ㅅㅗㅇㄱㅗ	기자나 작가 등이 원고를 편집 담당자에게 보냄.
송구	ㅅㅗㅇㄱㅜ	공으로 하는 운동 경기에서, 공을 자기편 선수에게 던져 보냄.
송부	ㅅㅗㅇㅂㅜ	편지나 서류, 물건 등을 부치어 보냄.
송사	ㅅㅗㅇㅅㅏ	사람들 사이에 일어난 다툼을 법률에 따라 판결해 달라고 법원에 요구함. 또는 그런 절차.
송어	ㅅㅗㅇㅇㅓ	푸른색 등에 까만 점이 있고 배는 은백색이며 바다와 강에 사는 물고기.
송이	ㅅㅗㅇㅇㅣ	꽃이나 열매 등이 따로따로 달린 한 덩이.
송치	ㅅㅗㅇㅊㅣ	수사 기관에서 어떤 사건의 피의자와 관련 서류를 검찰이나 상급 기관에 보냄.
쇼핑	ㅅㅛㅍㅣㅇ	백화점이나 가게를 돌아다니고 구경하면서 물건을 사는 일.
수감	ㅅㅜㄱㅏㅁ	사람을 감옥에 가둠.
수갑	ㅅㅜㄱㅏㅂ	사람이 자유롭게 움직일 수 없도록 양쪽 손목에 걸어서 채우는 기구.
수강	ㅅㅜㄱㅏㅇ	강의나 강습을 받음.
수건	ㅅㅜㄱㅓㄴ	몸, 얼굴, 손의 물기를 닦는 데 쓰는 천.
수경	ㅅㅜㄱㅕㅇ	수영할 때 눈에 물이 들어가지 않도록 하여 물속에서 눈을 뜨고 앞을 볼 수 있게 만든 안경.
수공	ㅅㅜㄱㅗㅇ	어떤 것을 손으로 직접 만드는 일.
수괴	ㅅㅜㄱㅗㅣ	나쁜 짓을 하는 무리의 우두머리.
수국	ㅅㅜㄱㅜㄱ	잎은 넓은 타원형에 연한 붉은색이나 보라색, 흰색의 꽃이 공처럼 동그랗게 모여서 피는, 높이 일 미터 정도의 나무. 또는 그 꽃.
수금	ㅅㅜㄱㅡㅁ	받을 돈을 직접 거두어들임. 또는 그렇게 받은 돈.
수급	ㅅㅜㄱㅡㅂ	급여나 연금, 배급 등을 받음.
수긍	ㅅㅜㄱㅡㅇ	옳다고 여겨 인정함.
수난	ㅅㅜㄴㅏㄴ	견디기 힘든 어려운 일을 당함.
수납	ㅅㅜㄴㅏㅂ	은행이나 공공 기관 등에서 돈이나 물건 등을 받아 거두어들임.
수년	ㅅㅜㄴㅕㄴ	주로 십 년을 넘지 않는 여러 해.
수놈	ㅅㅜㄴㅗㅁ	수컷인 동물.
수뇌	ㅅㅜㄴㅗㅣ	조직이나 단체에서 가장 중요한 지위에 있는 사람.
수능	ㅅㅜㄴㅡㅇ	‘대학 수학 능력 시험’을 줄여 이르는 말.
수단	ㅅㅜㄷㅏㄴ	어떤 목적을 이루기 위하여 쓰는 방법이나 도구.
수달	ㅅㅜㄷㅏㄹ	몸은 갈색이고 꼬리는 길며 짧은 네 발에 물갈퀴가 있는, 수중생활을 하는 동물.
수당	ㅅㅜㄷㅏㅇ	정해진 봉급 외에 추가로 따로 받는 보수.
수동	ㅅㅜㄷㅗㅇ	기계 등의 힘을 사용하지 않고 사람이 직접 손의 힘만으로 움직임. 또는 손의 힘만으로 움직이도록 되어 있는 것.
수락	ㅅㅜㄹㅏㄱ	요구를 받아들임.
수량	ㅅㅜㄹㅑㅇ	수와 양.
수렁	ㅅㅜㄹㅓㅇ	흙과 물이 뒤섞여 질퍽거리는 깊은 웅덩이.
수레	ㅅㅜㄹㅓㅣ	사람을 태우거나 짐을 싣는 데 쓰는, 사람이나 짐승이 끄는 바퀴가 달린 기구.
수력	ㅅㅜㄹㅕㄱ	물이 흐르거나 떨어질 때 발생하는 힘.
수련	ㅅㅜㄹㅕㄴ	인격, 기술, 학문 등을 열심히 배우고 익힘.
수렴	ㅅㅜㄹㅕㅁ	돈이나 물건 등을 거두어들임.
수렵	ㅅㅜㄹㅕㅂ	사람이 산이나 들에 나가 총이나 활 등으로 짐승을 잡는 일.
수령	ㅅㅜㄹㅕㅇ	(옛날에) 각 지역을 맡아 다스리던 관리.
수록	ㅅㅜㄹㅗㄱ	자료를 책이나 음반 등에 실음.
수뢰	ㅅㅜㄹㅗㅣ	뇌물을 받음.
수륙	ㅅㅜㄹㅠㄱ	물과 육지.
수립	ㅅㅜㄹㅣㅂ	국가, 정부나 제도, 계획 등을 세움.
수매	ㅅㅜㅁㅏㅣ	기관이나 단체에서 농작물이나 물품 등을 거두어 사들임. 또는 그런 일.
수면	ㅅㅜㅁㅕㄴ	물의 표면.
수명	ㅅㅜㅁㅕㅇ	사람이나 동식물이 살아 있는 기간.
수목	ㅅㅜㅁㅗㄱ	살아 있는 나무.
수몰	ㅅㅜㅁㅗㄹ	물속에 잠김.
수묵	ㅅㅜㅁㅜㄱ	빛이 엷은 먹물.
수문	ㅅㅜㅁㅜㄴ	물의 흐름을 막거나 물의 양을 조절하기 위해 설치한 문.
수박	ㅅㅜㅂㅏㄱ	둥글고 크며 초록 빛깔에 검푸른 줄무늬가 있으며 속이 붉고 수분이 많은 과일.
수반	ㅅㅜㅂㅏㄴ	신분, 등급 등의 차례 가운데 가장 높은 자리.
수발	ㅅㅜㅂㅏㄹ	곁에서 보살피며 시중을 듦.
수배	ㅅㅜㅂㅏㅣ	경찰이나 검찰이 범인을 잡기 위해 찾아다님.
수법	ㅅㅜㅂㅓㅂ	수단과 방법.
수복	ㅅㅜㅂㅗㄱ	잃었던 땅이나 권리 등을 되찾음.
수분	ㅅㅜㅂㅜㄴ	물건이나 물질에 들어 있는 물.
수산	ㅅㅜㅅㅏㄴ	바다나 강 등의 물에서 나는 것. 또는 그런 물건.
수삼	ㅅㅜㅅㅏㅁ	말리지 않은 인삼.
수상	ㅅㅜㅅㅏㅇ	물의 위. 또는 물이 흐르는 길.
수석	ㅅㅜㅅㅓㄱ	물과 돌.
수선	ㅅㅜㅅㅓㄴ	사람의 정신을 어지럽게 만드는 시끄러운 말이나 혼란스러운 행동.
수성	ㅅㅜㅅㅓㅇ	물에 잘 녹는 성질.
수세	ㅅㅜㅅㅓㅣ	적의 공격에 몰려서 방어를 하는 상황. 또는 그 세력.
수속	ㅅㅜㅅㅗㄱ	일을 시작하거나 처리하기 전에 거쳐야 할 과정이나 단계.
수송	ㅅㅜㅅㅗㅇ	기차, 자동차, 배, 비행기 등으로 사람이나 물건을 실어 옮김.
수순	ㅅㅜㅅㅜㄴ	어떤 일을 하는 데 정해진 순서나 일이 이루어지는 차례.
수술	ㅅㅜㅅㅜㄹ	꽃의 가운데에 있으며 꽃가루를 만드는 기관.
수습	ㅅㅜㅅㅡㅂ	흩어진 재산이나 물건을 거두어 정돈함.
수식	ㅅㅜㅅㅣㄱ	겉모양을 꾸밈.
수신	ㅅㅜㅅㅣㄴ	우편이나 전보 등의 통신을 받음. 또는 그런 일.
수실	ㅅㅜㅅㅣㄹ	바늘에 꿰어 천에 그림, 글씨, 무늬를 떠서 놓는 데에 쓰는 실.
수심	ㅅㅜㅅㅣㅁ	강이나 바다, 호수 등의 물의 깊이.
수압	ㅅㅜㅇㅏㅂ	물의 압력.
수양	ㅅㅜㅇㅑㅇ	몸과 마음을 단련하여 품성이나 지식, 도덕심 등을 기르는 일.
수업	ㅅㅜㅇㅓㅂ	학문이나 기술을 배우고 익힘.
수역	ㅅㅜㅇㅕㄱ	바다, 강, 하천 등의 일정한 구역.
수열	ㅅㅜㅇㅕㄹ	일정한 규칙에 따라 한 줄로 늘어놓은 수의 열.
수염	ㅅㅜㅇㅕㅁ	남자 어른의 입 주변이나 턱, 뺨에 나는 털.
수영	ㅅㅜㅇㅕㅇ	물속을 헤엄침.
수예	ㅅㅜㅇㅕㅣ	자수, 뜨개질 등과 같이 실이나 헝겊을 이용해 손으로 물건을 만드는 일.
수온	ㅅㅜㅇㅗㄴ	물의 온도.
수용	ㅅㅜㅇㅛㅇ	본래 개인의 소유였던 것을 국가나 공공 기관이 거두어들여 사용함.
수위	ㅅㅜㅇㅜㅣ	강, 바다, 호수 등의 물의 높이.
수육	ㅅㅜㅇㅠㄱ	삶아서 물기를 빼고 썰어 놓은 고기.
수은	ㅅㅜㅇㅡㄴ	상온에서 액체 상태이며, 온도계나 의약품 등을 만드는 데 쓰는 은백색 금속.
수의	ㅅㅜㅇㅡㅣ	감옥에 갇힌 죄수가 입는 옷.
수익	ㅅㅜㅇㅣㄱ	일이나 사업 등에서 얻은 이익.
수일	ㅅㅜㅇㅣㄹ	길지 않은 여러 날.
수임	ㅅㅜㅇㅣㅁ	임무를 받음.
수입	ㅅㅜㅇㅣㅂ	어떤 일을 하여 돈이나 물건 등을 거두어들임. 또는 그 돈이나 물건.
수작	ㅅㅜㅈㅏㄱ	몹시 뛰어난 작품.
수장	ㅅㅜㅈㅏㅇ	죽은 사람을 물속에 넣어 장사를 지냄.
수재	ㅅㅜㅈㅏㅣ	비가 많이 와서 일어난 재난.
수적	ㅅㅜㅈㅓㄱ	수와 관련되거나 수를 기준으로 하는 것.
수절	ㅅㅜㅈㅓㄹ	남편이 죽고 나서 다시 결혼하지 않고 혼자 지냄.
수정	ㅅㅜㅈㅓㅇ	빛깔이 없고 투명하며 단단한 광물.
수제	ㅅㅜㅈㅓㅣ	손으로 만듦.
수족	ㅅㅜㅈㅗㄱ	손과 발.
수종	ㅅㅜㅈㅗㅇ	몇 가지의 종류.
수준	ㅅㅜㅈㅜㄴ	사물의 가치나 질 등을 판단하는 기준이 되는 정도.
수중	ㅅㅜㅈㅜㅇ	손의 안.
수직	ㅅㅜㅈㅣㄱ	사물이 아래로 곧게 내려가거나 떨어지는 상태.
수질	ㅅㅜㅈㅣㄹ	온도, 맑고 흐림, 빛깔, 비중, 어떤 물질이나 세균이 포함된 양 등에 따라 결정되는 물의 성질.
수집	ㅅㅜㅈㅣㅂ	흩어져 있던 것을 거두어 모음.
수채	ㅅㅜㅊㅏㅣ	물감을 물에 풀어서 그림을 그리는 방법.
수첩	ㅅㅜㅊㅓㅂ	필요할 때 간단히 적기 위해 들고 다니는 작은 크기의 공책.
수청	ㅅㅜㅊㅓㅇ	(옛날에) 기생이 높은 관직에서 일하는 사람에게 몸을 바쳐 시중을 들던 일. 또는 그 기생.
수축	ㅅㅜㅊㅜㄱ	줄어들거나 오그라들어 크기가 작아짐.
수출	ㅅㅜㅊㅜㄹ	국내의 상품이나 기술을 외국으로 팔아 내보냄.
수취	ㅅㅜㅊㅜㅣ	받아서 가짐.
수칙	ㅅㅜㅊㅣㄱ	지키도록 정한 규칙.
수캐	ㅅㅜㅋㅏㅣ	수컷인 개.
수컷	ㅅㅜㅋㅓㅅ	암수 구별이 있는 동물 중에 새끼를 배지 않는 쪽.
수탁	ㅅㅜㅌㅏㄱ	상업이나 거래에서 다른 사람의 부탁을 받음. 또는 그런 일.
수탈	ㅅㅜㅌㅏㄹ	약한 상대의 것을 강제로 빼앗음.
수태	ㅅㅜㅌㅏㅣ	사람이나 짐승이 배 속에 아이나 새끼를 가짐.
수판	ㅅㅜㅍㅏㄴ	수를 계산하는 데에 쓰는, 막대에 구슬들을 꿰어 만든 도구.
수평	ㅅㅜㅍㅕㅇ	표면이 기울지 않고 평평한 상태.
수풀	ㅅㅜㅍㅜㄹ	나무나 풀이 빽빽하게 많이 나 있는 곳.
수필	ㅅㅜㅍㅣㄹ	어떤 주제에 대하여 개인적인 느낌이나 의견을 자유로운 형식으로 쓴 글.
수학	ㅅㅜㅎㅏㄱ	어떤 분야를 배워서 익힘.
수해	ㅅㅜㅎㅏㅣ	장마나 홍수로 인한 피해.
수험	ㅅㅜㅎㅓㅁ	시험을 치름.
수혈	ㅅㅜㅎㅕㄹ	치료를 목적으로 건강한 사람의 피를 환자에게 옮겨 넣음.
수형	ㅅㅜㅎㅕㅇ	지은 죄에 대한 벌을 받음.
수혜	ㅅㅜㅎㅕㅣ	이익이나 도움을 받음.
수화	ㅅㅜㅎㅗㅏ	듣지 못하거나 말하지 못하는 사람들 사이에서, 또는 그들과 대화할 때 손짓이나 몸짓으로 표현하는 의사 전달 방법.
수회	ㅅㅜㅎㅗㅣ	여러 번.
수훈	ㅅㅜㅎㅜㄴ	나라나 회사 등의 단체를 위해 세운 가장 큰 공로.
숙고	ㅅㅜㄱㄱㅗ	깊고 신중히 잘 생각함. 또는 그런 생각.
숙녀	ㅅㅜㄱㄴㅕ	교양과 예의와 품격을 두루 갖춘 여자.
숙모	ㅅㅜㄱㅁㅗ	아버지 동생의 아내를 이르거나 부르는 말.
숙부	ㅅㅜㄱㅂㅜ	아버지의 결혼한 남동생.
숙소	ㅅㅜㄱㅅㅗ	집이 아닌 임시로 머물러 묵는 곳.
숙어	ㅅㅜㄱㅇㅓ	오랫동안 관습적으로 쓰이면서 특별한 의미를 가지게 된 여러 단어로 이루어진 짧은 말.
숙주	ㅅㅜㄱㅈㅜ	녹두에 물을 주어서 싹을 낸 나물.
순교	ㅅㅜㄴㄱㅛ	자기가 믿는 종교를 위하여 목숨을 바침.
순도	ㅅㅜㄴㄷㅗ	어떤 물질 가운데에서 주된 성분인 순물질이 차지하는 비율.
순리	ㅅㅜㄴㄹㅣ	마땅한 도리나 이치.
순서	ㅅㅜㄴㅅㅓ	정해진 기준에서 앞뒤, 좌우, 위아래 등으로 벌여진 관계.
순수	ㅅㅜㄴㅅㅜ	다른 것이 전혀 섞이지 않음.
순시	ㅅㅜㄴㅅㅣ	공적인 일로 어떤 지역을 돌아다니며 사정을 살핌.
순차	ㅅㅜㄴㅊㅏ	돌아오는 차례.
술수	ㅅㅜㄹㅅㅜ	어떤 일을 꾸미는 꾀나 방법.
술어	ㅅㅜㄹㅇㅓ	문장 안에서 주어의 성질, 상태, 움직임 등을 나타내는 말.
숫기	ㅅㅜㅅㄱㅣ	남을 대할 때 부끄러워하지 않고 활발한 기운.
숫자	ㅅㅜㅅㅈㅏ	수를 나타내는 글자.
숭어	ㅅㅜㅇㅇㅓ	등이 푸르며 배는 하얗고 몸에 둥근 비늘이 덮여 있는, 강 하구나 연안에 사는 물고기.
슈팅	ㅅㅠㅌㅣㅇ	축구나 농구 등 공을 사용하는 경기에서 골이나 바스켓으로 공을 차거나 던지는 일.
스님	ㅅㅡㄴㅣㅁ	부처의 가르침을 수행하는 승려가 자기 스승을 이르는 말.
스릴	ㅅㅡㄹㅣㄹ	공연이나 영화, 소설 등에서 두려운 마음이 들게 하거나 마음을 조마조마하게 만드는 느낌.
스승	ㅅㅡㅅㅡㅇ	자기를 가르치고 이끌어 주는 사람.
스틱	ㅅㅡㅌㅣㄱ	하키 등의 운동 경기에 쓰이는 긴 막대 모양의 기구.
스팀	ㅅㅡㅌㅣㅁ	더운물이나 뜨거운 김을 이용하여 열을 내는 난방 장치.
스푼	ㅅㅡㅍㅜㄴ	음식을 먹거나 차를 마실 때 쓰는, 둥글고 오목한 부분과 긴 손잡이가 있으며 크기가 다양한 기구.
스핀	ㅅㅡㅍㅣㄴ	물리에서, 소립자가 가지고 있는 스스로 회전하는 성질.
슬기	ㅅㅡㄹㄱㅣ	사물의 이치나 주어진 상황 등을 바르게 판단하여 일을 잘 처리하는 재능.
슬하	ㅅㅡㄹㅎㅏ	부모가 자식을 키우고 보살피는 상태.
습기	ㅅㅡㅂㄱㅣ	물기가 있어 축축한 기운.
습도	ㅅㅡㅂㄷㅗ	공기 속에 수증기가 포함되어 있는 정도.
습지	ㅅㅡㅂㅈㅣ	습기가 많아 늘 축축한 땅.
승려	ㅅㅡㅇㄹㅕ	절에서 살면서 불교의 의식을 치르고 부처의 가르침을 실천하는 사람.
승리	ㅅㅡㅇㄹㅣ	전쟁이나 경기 등에서 이김.
승마	ㅅㅡㅇㅁㅏ	말을 탐.
승무	ㅅㅡㅇㅁㅜ	비행기, 기차, 배 등에서 운행이나 승객에 관한 일을 맡아서 함.
승부	ㅅㅡㅇㅂㅜ	이김과 짐.
승소	ㅅㅡㅇㅅㅗ	재판에서 이김.
승자	ㅅㅡㅇㅈㅏ	싸움이나 경기 등에서 이긴 사람. 또는 그런 단체.
승차	ㅅㅡㅇㅊㅏ	차를 탐.
시각	ㅅㅣㄱㅏㄱ	연속되는 시간의 어느 한 지점.
시간	ㅅㅣㄱㅏㄴ	어떤 때에서 다른 때까지의 동안.
시계	ㅅㅣㄱㅕㅣ	시간을 나타내는 기계.
시골	ㅅㅣㄱㅗㄹ	도시에서 떨어져 있어 인구가 적고 개발이 덜 된 곳.
시공	ㅅㅣㄱㅗㅇ	공사를 실제로 함.
시국	ㅅㅣㄱㅜㄱ	현재 놓여 있는 나라 안팎의 형편이나 상황.
시급	ㅅㅣㄱㅡㅂ	일한 시간에 따라 받는 돈.
시내	ㅅㅣㄴㅏㅣ	골짜기나 들판에 흐르는 작은 물줄기.
시늉	ㅅㅣㄴㅠㅇ	어떤 모양이나 동작을 실제로 하는 것처럼 흉내 냄.
시달	ㅅㅣㄷㅏㄹ	높은 직위나 기관에서 그보다 낮은 직위나 기관으로 명령이나 문서를 전달함.
시대	ㅅㅣㄷㅏㅣ	역사적으로 어떤 특징을 기준으로 나눈 일정한 기간.
시동	ㅅㅣㄷㅗㅇ	처음으로 움직이기 시작함. 또는 그렇게 되게 함.
시럽	ㅅㅣㄹㅓㅂ	설탕을 넣고 졸여서 만든 걸쭉한 액체.
시력	ㅅㅣㄹㅕㄱ	물체를 볼 수 있는 눈의 능력.
시련	ㅅㅣㄹㅕㄴ	힘든 고난이나 고비.
시론	ㅅㅣㄹㅗㄴ	그때그때 사회적으로 쟁점이 될 만한 일에 대한 평론.
시름	ㅅㅣㄹㅡㅁ	마음에 걸려 풀리지 않고 항상 남아 있는 근심과 걱정.
시립	ㅅㅣㄹㅣㅂ	공공의 이익을 위하여 시의 예산으로 설립하고 관리함.
시문	ㅅㅣㅁㅜㄴ	시와 산문.
시민	ㅅㅣㅁㅣㄴ	한 도시 안에 살고 있는 사람.
시발	ㅅㅣㅂㅏㄹ	차나 기차, 배 등이 맨 처음으로 출발함.
시방	ㅅㅣㅂㅏㅇ	말하고 있는 바로 이때. 지금.
시범	ㅅㅣㅂㅓㅁ	모범이 되는 본보기를 보임.
시상	ㅅㅣㅅㅏㅇ	잘한 일이나 뛰어난 성적을 칭찬하는 상장, 상품, 상금 등을 줌.
시선	ㅅㅣㅅㅓㄴ	어떤 방향으로 바라보고 있는 눈.
시설	ㅅㅣㅅㅓㄹ	어떤 목적을 위하여 건물이나 도구, 기계, 장치 등의 물건을 만듦. 또는 그런 건물이나 도구, 기계, 장치 등의 물건.
시세	ㅅㅣㅅㅓㅣ	그때그때의 세상 형편.
시속	ㅅㅣㅅㅗㄱ	한 시간을 단위로 하여 잰 속도.
시숙	ㅅㅣㅅㅜㄱ	남편의 형제.
시술	ㅅㅣㅅㅜㄹ	병이나 상처 등을 낫게 하기 위하여 의학적인 처치를 함. 또는 그런 일.
시승	ㅅㅣㅅㅡㅇ	자동차 등의 탈것이나 말 등을 시험 삼아 타 봄.
시식	ㅅㅣㅅㅣㄱ	음식 맛이나 요리 솜씨를 알아보려고 시험 삼아 음식을 먹어 봄.
시신	ㅅㅣㅅㅣㄴ	(점잖게 이르는 말로) 죽은 사람의 몸.
시약	ㅅㅣㅇㅑㄱ	화학에서, 어떤 물질의 성분을 알아내거나 양을 재는 데 쓰는 약.
시연	ㅅㅣㅇㅕㄴ	무용이나 연극 등을 일반 관객에게 보여 주기 전에 특정한 사람들에게 시험 삼아 먼저 보여 줌.
시영	ㅅㅣㅇㅕㅇ	시의 사업으로 관리하고 운영하는 일. 또는 그 사업.
시옷	ㅅㅣㅇㅗㅅ	한글 자모 ‘ㅅ’의 이름.
시외	ㅅㅣㅇㅗㅣ	도시의 바깥.
시운	ㅅㅣㅇㅜㄴ	어떤 시대나 시기의 운수.
시위	ㅅㅣㅇㅜㅣ	화살을 걸어서 잡아당겼다 놓아 멀리 날아가게 하는, 활대에 팽팽하게 걸어 놓은 줄.
시음	ㅅㅣㅇㅡㅁ	술이나 음료수 등의 맛을 알기 위해 조금 마셔 보는 일.
시인	ㅅㅣㅇㅣㄴ	어떤 내용이나 사실이 맞거나 그러하다고 인정함.
시일	ㅅㅣㅇㅣㄹ	어떤 일을 끝내는 데 걸리는 기간이나 시간.
시작	ㅅㅣㅈㅏㄱ	어떤 일이나 행동의 처음 단계를 이루거나 이루게 함. 또는 그런 단계.
시장	ㅅㅣㅈㅏㅇ	시를 다스리는 최고 책임자.
시적	ㅅㅣㅈㅓㄱ	시의 느낌을 가진 것.
시절	ㅅㅣㅈㅓㄹ	특정한 시기나 때.
시점	ㅅㅣㅈㅓㅁ	어떠한 것이 처음으로 일어나거나 시작되는 곳.
시정	ㅅㅣㅈㅓㅇ	사람이 사는 집이 모여 있는 곳.
시제	ㅅㅣㅈㅓㅣ	언어에서, 현재, 과거, 미래 등의 시간을 표현하는 문법.
시종	ㅅㅣㅈㅗㅇ	처음과 끝.
시중	ㅅㅣㅈㅜㅇ	옆에서 여러 가지 심부름을 하는 일.
시즌	ㅅㅣㅈㅡㄴ	어떤 활동이 활발하게 이루어지는 시기. 또는 어떤 활동을 하기 좋은 시기.
시집	ㅅㅣㅈㅣㅂ	남편의 부모가 사는 집. 또는 남편의 집안.
시찰	ㅅㅣㅊㅏㄹ	두루 돌아다니며 현장의 분위기나 사정을 살핌.
시청	ㅅㅣㅊㅓㅇ	시의 행정 사무를 맡아보는 기관.
시체	ㅅㅣㅊㅓㅣ	죽은 사람의 몸.
시침	ㅅㅣㅊㅣㅁ	자기가 하고도 하지 않은 척하거나 알고도 모르는 척하는 태도.
시판	ㅅㅣㅍㅏㄴ	상품을 시장에서 일반 대중에게 판매함.
시한	ㅅㅣㅎㅏㄴ	기간의 끝으로 정한 날짜나 시각.
시합	ㅅㅣㅎㅏㅂ	운동 등의 경기에서 서로 실력을 발휘하여 승부를 겨룸.
시해	ㅅㅣㅎㅏㅣ	부모나 대통령, 임금 등의 지위가 높은 사람을 죽임.
시험	ㅅㅣㅎㅓㅁ	문제, 질문, 실제의 행동 등의 일정한 절차에 따라 지식이나 능력을 검사하고 평가하는 일.
시현	ㅅㅣㅎㅕㄴ	나타내 보임.
시화	ㅅㅣㅎㅗㅏ	시와 그림.
식구	ㅅㅣㄱㄱㅜ	한집에서 함께 사는 사람.
식기	ㅅㅣㄱㄱㅣ	음식을 담는 그릇.
식도	ㅅㅣㄱㄷㅗ	목으로 넘긴 음식물을 위까지 연결하는 소화 기관.
식모	ㅅㅣㄱㅁㅗ	남의 집에 고용되어 주로 집안일을 맡아 하는 여자.
식비	ㅅㅣㄱㅂㅣ	먹는 데 드는 돈.
식사	ㅅㅣㄱㅅㅏ	아침, 점심, 저녁과 같이 날마다 일정한 시간에 음식을 먹는 일. 또는 그 음식.
식수	ㅅㅣㄱㅅㅜ	먹을 물. 또는 먹을 수 있는 물.
식자	ㅅㅣㄱㅈㅏ	지식이 있는 사람.
식초	ㅅㅣㄱㅊㅗ	원료를 발효시켜서 만드는 신맛이 나는 액체 조미료.
식후	ㅅㅣㄱㅎㅜ	밥을 먹은 뒤.
신고	ㅅㅣㄴㄱㅗ	어떠한 사실을 행정 관청에 알림.
신교	ㅅㅣㄴㄱㅛ	종교 개혁에 의해 가톨릭에서 갈라져 나온 기독교의 한 교파.
신구	ㅅㅣㄴㄱㅜ	새것과 헌것.
신규	ㅅㅣㄴㄱㅠ	무엇을 새로 함.
신기	ㅅㅣㄴㄱㅣ	매우 뛰어난 기술.
신도	ㅅㅣㄴㄷㅗ	어떤 종교를 믿고 따르는 사람.
신라	ㅅㅣㄴㄹㅏ	우리나라 고대의 삼국 가운데 한반도의 남동쪽에 있던 나라. 기원전 57년 박혁거세가 세웠다고 하며 수도는 경주이다. 삼국을 통일하였으나 935년에 고려 태조인 왕건에게 망하였다.
신부	ㅅㅣㄴㅂㅜ	가톨릭에서, 사제로 임명을 받아 종교적인 의식을 진행하는 성직자.
신비	ㅅㅣㄴㅂㅣ	보통의 생각으로는 이해할 수 없는 놀랍고 신기한 일.
신사	ㅅㅣㄴㅅㅏ	태도가 점잖고 교양이 있는 예의 바른 남자.
신수	ㅅㅣㄴㅅㅜ	사람의 얼굴이나 외모.
신어	ㅅㅣㄴㅇㅓ	새로 생긴 말.
신자	ㅅㅣㄴㅈㅏ	종교를 믿는 사람.
신조	ㅅㅣㄴㅈㅗ	굳게 믿어 지키고 있는 생각.
신주	ㅅㅣㄴㅈㅜ	죽은 사람의 이름을 적고 사당이나 절에 두는, 나무로 만든 패.
신차	ㅅㅣㄴㅊㅏ	새로 나온 차.
신파	ㅅㅣㄴㅍㅏ	지금까지와는 다른 생각이나 방식을 따르는 새로운 무리.
신하	ㅅㅣㄴㅎㅏ	임금을 섬기어 나랏일을 맡아서 하는 관리.
신호	ㅅㅣㄴㅎㅗ	어떤 내용의 전달을 위해 서로 약속하여 사용하는 일정한 소리, 색깔, 빛, 몸짓 등의 부호.
실기	ㅅㅣㄹㄱㅣ	때를 놓침.
실리	ㅅㅣㄹㄹㅣ	실제로 얻는 이익.
실무	ㅅㅣㄹㅁㅜ	실제로 하는 업무나 사무.
실비	ㅅㅣㄹㅂㅣ	실같이 가늘게 내리는 비.
실사	ㅅㅣㄹㅅㅏ	실제의 상황이나 상태 등을 조사하거나 검사함.
실소	ㅅㅣㄹㅅㅗ	어처구니가 없어 자기도 모르게 웃음이 툭 터져 나옴. 또는 그 웃음.
실수	ㅅㅣㄹㅅㅜ	잘 알지 못하거나 조심하지 않아서 저지르는 잘못.
실시	ㅅㅣㄹㅅㅣ	어떤 일이나 법, 제도 등을 실제로 행함.
실지	ㅅㅣㄹㅈㅣ	있는 그대로의 상태나 사실.
실추	ㅅㅣㄹㅊㅜ	명예나 체면 등을 떨어뜨리거나 잃음.
실크	ㅅㅣㄹㅋㅡ	명주실, 또는 명주실로 짠 천.
실토	ㅅㅣㄹㅌㅗ	숨기고 있던 것을 사실대로 말함.
실효	ㅅㅣㄹㅎㅛ	효력을 잃음.
심기	ㅅㅣㅁㄱㅣ	마음으로 느끼는 기분.
심도	ㅅㅣㅁㄷㅗ	깊은 정도.
심려	ㅅㅣㅁㄹㅕ	마음속으로 매우 걱정함. 또는 그런 걱정.
심리	ㅅㅣㅁㄹㅣ	마음의 움직임이나 의식의 상태.
심보	ㅅㅣㅁㅂㅗ	마음을 쓰는 태도.
심사	ㅅㅣㅁㅅㅏ	어떤 일에 대한 감정이나 마음.
심야	ㅅㅣㅁㅇㅑ	아주 늦은 밤.
심지	ㅅㅣㅁㅈㅣ	초나 등잔 등에 불을 붙이기 위해 꼬아서 꽂은 실이나 헝겊.
십자	ㅅㅣㅂㅈㅏ	‘十’ 자와 같은 모양.
쓰기	ㅅㅅㅡㄱㅣ	생각이나 느낌을 글로 표현하는 일.
아군	ㅇㅏㄱㅜㄴ	우리 편 군대.
아귀	ㅇㅏㄱㅜㅣ	사물의 갈라진 부분.
아까	ㅇㅏㄱㄱㅏ	조금 전.
아낙	ㅇㅏㄴㅏㄱ	남의 집 부녀자.
아내	ㅇㅏㄴㅏㅣ	결혼하여 남자의 짝이 된 여자.
아동	ㅇㅏㄷㅗㅇ	나이가 적은 아이.
아들	ㅇㅏㄷㅡㄹ	남자인 자식.
아래	ㅇㅏㄹㅏㅣ	일정한 기준보다 낮은 위치.
아량	ㅇㅏㄹㅑㅇ	너그러운 마음씨.
아령	ㅇㅏㄹㅕㅇ	길지 않은 막대기의 양 끝에 둥글고 무거운 것이 달려 있어, 양손에 하나씩 들고 팔 운동을 하는 운동 기구.
아름	ㅇㅏㄹㅡㅁ	두 팔을 둥글게 모아서 만든 둘레.
아명	ㅇㅏㅁㅕㅇ	아이 때의 이름.
아범	ㅇㅏㅂㅓㅁ	(조금 대접하는 말로) 자식이 있는 남자를 이르거나 부르는 말. 
아빠	ㅇㅏㅂㅂㅏ	격식을 갖추지 않아도 되는 상황에서 아버지를 이르거나 부르는 말.
아양	ㅇㅏㅇㅑㅇ	다른 사람에게 잘 보이거나 귀여움을 받으려고 하는 애교 있는 말. 또는 그런 행동.
아역	ㅇㅏㅇㅕㄱ	연극이나 영화에서 어린아이의 역할. 또는 그 역할을 맡은 배우.
아웃	ㅇㅏㅇㅜㅅ	테니스, 탁구, 농구, 배구 등에서 공이 일정한 선 밖으로 나가는 일.
아첨	ㅇㅏㅊㅓㅁ	남에게 잘 보이려고 꾸며 말하거나 행동함. 또는 그런 말이나 행동.
아침	ㅇㅏㅊㅣㅁ	날이 밝아올 때부터 해가 떠올라 하루의 일이 시작될 때쯤까지의 시간.
아편	ㅇㅏㅍㅕㄴ	덜 익은 양귀비 열매의 진을 말린 고무 모양의 흑갈색 물질.
아픔	ㅇㅏㅍㅡㅁ	육체적으로 괴로운 느낌.
악기	ㅇㅏㄱㄱㅣ	음악을 연주하는 데 쓰는 기구.
악마	ㅇㅏㄱㅁㅏ	불교에서, 수행을 방해하여 악한 길로 유혹하는 나쁜 귀신.
악보	ㅇㅏㄱㅂㅗ	음악의 곡조를 여러 가지 글자나 음표 등을 써서 기록한 것.
악사	ㅇㅏㄱㅅㅏ	악기를 연주하는 사람.
악수	ㅇㅏㄱㅅㅜ	인사, 감사, 화해 등의 뜻으로 두 사람이 각자 한 손을 내밀어 마주 잡는 일.
악어	ㅇㅏㄱㅇㅓ	열대의 강이나 호수에서 살며 생김새는 도마뱀과 비슷하나 몸집은 훨씬 크고 이빨이 날카로우며 물고기나 다른 동물들을 잡아 먹고 사는 동물.
안구	ㅇㅏㄴㄱㅜ	눈의 구멍 안에 있는 동그란 모양의 기관.
안도	ㅇㅏㄴㄷㅗ	사는 곳에서 평안하게 잘 지냄. 또는 평안히 지낼 수 있는 곳.
안료	ㅇㅏㄴㄹㅛ	색채가 있고 물이나 그 밖의 용제에 녹지 않는 고운 가루.
안마	ㅇㅏㄴㅁㅏ	손으로 몸을 두드리거나 주물러서 피가 잘 돌게 하고 피로를 풀어 주는 일.
안무	ㅇㅏㄴㅁㅜ	음악에 맞추어 춤을 만들거나 가르침.
안보	ㅇㅏㄴㅂㅗ	편안하게 보호되어 지켜짐. 또는 편안하게 보호하여 지킴.
안부	ㅇㅏㄴㅂㅜ	어떤 사람이 편안하게 잘 지내는지에 대한 소식. 또는 인사로 그것을 전하거나 묻는 일.
안주	ㅇㅏㄴㅈㅜ	한곳에 자리를 잡고 편안하게 삶.
안치	ㅇㅏㄴㅊㅣ	안전하게 둠.
안타	ㅇㅏㄴㅌㅏ	야구에서, 타자가 한 베이스 이상을 갈 수 있도록 공을 치는 일.
알라	ㅇㅏㄹㄹㅏ	이슬람교의 유일하고 절대적이며 전능한 신.
알토	ㅇㅏㄹㅌㅗ	성악에서, 여성의 가장 낮은 음역. 또는 그 음역의 가수.
암기	ㅇㅏㅁㄱㅣ	잊지 않고 머릿속으로 외움.
암수	ㅇㅏㅁㅅㅜ	암컷과 수컷.
암시	ㅇㅏㅁㅅㅣ	직접 드러나지 않게 가만히 알림. 또는 그 내용.
암초	ㅇㅏㅁㅊㅗ	바다나 강에서 물속에 잠겨 겉으로 보이지 않는 험한 바위.
암표	ㅇㅏㅁㅍㅛ	불법으로 몰래 사고파는 표.
암호	ㅇㅏㅁㅎㅗ	비밀을 지키기 위해 관계가 있는 사람들끼리만 알 수 있게 정한 기호.
압도	ㅇㅏㅂㄷㅗ	뛰어난 힘이나 능력으로 상대방을 눌러 꼼짝 못 하게 함.
압류	ㅇㅏㅂㄹㅠ	법에 따라 채무자가 자신의 재산을 사용하거나 처분하지 못하게 하는 일.
압사	ㅇㅏㅂㅅㅏ	무거운 것에 눌려 죽음.
압수	ㅇㅏㅂㅅㅜ	법원이나 경찰 등의 수사 기관이 증거 수집이나 조사의 목적으로 물건을 강제로 가져감.
앞니	ㅇㅏㅍㄴㅣ	앞쪽으로 위아래에 각각 네 개씩 나 있는 이.
애교	ㅇㅏㅣㄱㅛ	남에게 귀엽게 보이려는 태도.
애기	ㅇㅏㅣㄱㅣ	→ 아기
애도	ㅇㅏㅣㄷㅗ	사람의 죽음을 슬퍼함.
애로	ㅇㅏㅣㄹㅗ	좁고 험한 길.
애마	ㅇㅏㅣㅁㅏ	자기가 아끼고 사랑하는 말.
애무	ㅇㅏㅣㅁㅜ	이성을 사랑하여 어루만짐.
애비	ㅇㅏㅣㅂㅣ	→ 아비
애초	ㅇㅏㅣㅊㅗ	맨 처음.
애호	ㅇㅏㅣㅎㅗ	사랑하고 좋아함.
야간	ㅇㅑㄱㅏㄴ	해가 진 뒤부터 다시 해가 뜨기 전까지의 동안.
야경	ㅇㅑㄱㅕㅇ	밤에 보이는 경치.
야근	ㅇㅑㄱㅡㄴ	퇴근 시간이 지나 밤늦게까지 하는 일.
야단	ㅇㅑㄷㅏㄴ	어떤 일 때문에 시끄럽게 자꾸 떠들거나 소란을 일으킴.
야당	ㅇㅑㄷㅏㅇ	현재 정권을 잡고 있지 않은 정당.
야만	ㅇㅑㅁㅏㄴ	문명의 수준이 낮고 미개한 상태.
야망	ㅇㅑㅁㅏㅇ	어떤 일을 이루겠다는 큰 희망이나 바람.
야밤	ㅇㅑㅂㅏㅁ	깊은 밤.
야산	ㅇㅑㅅㅏㄴ	들 가까이에 있는 낮은 산.
야성	ㅇㅑㅅㅓㅇ	자연 또는 본능 그대로의 거친 성질.
야식	ㅇㅑㅅㅣㄱ	밤에 먹는 음식.
야심	ㅇㅑㅅㅣㅁ	대단한 것을 이루어 보겠다고 마음속에 품고 있는 욕망이나 소망.
야영	ㅇㅑㅇㅕㅇ	군대가 어떤 지역에서 임시로 지내며 필요한 시설을 갖추어 놓은 곳. 또는 거기서 하는 생활.
야외	ㅇㅑㅇㅗㅣ	도시에서 조금 떨어져 있는 들판.
야채	ㅇㅑㅊㅏㅣ	밭에서 기르며 주로 그 잎이나 줄기, 열매를 먹는 농작물.
야학	ㅇㅑㅎㅏㄱ	밤에 공부를 함.
야합	ㅇㅑㅎㅏㅂ	부부가 아닌 남녀가 서로 정을 통함.
야회	ㅇㅑㅎㅗㅣ	밤에 모임을 엶. 또는 그 모임.
약도	ㅇㅑㄱㄷㅗ	간략하게 중요한 것만 그린 지도.
약사	ㅇㅑㄱㅅㅏ	약을 조제하고 파는 일 등을 직업으로 하는 사람.
약수	ㅇㅑㄱㅅㅜ	어떤 수를 나머지 없이 나눌 수 있는 수.
약어	ㅇㅑㄱㅇㅓ	단어의 일부분이 줄어든 말.
약자	ㅇㅑㄱㅈㅏ	힘이나 세력이 약한 사람.
약주	ㅇㅑㄱㅈㅜ	약으로 마시는 술.
약지	ㅇㅑㄱㅈㅣ	가운뎃손가락과 새끼손가락 사이에 있는 손가락.
약초	ㅇㅑㄱㅊㅗ	약으로 쓰는 풀.
약효	ㅇㅑㄱㅎㅛ	약의 효과.
양가	ㅇㅑㅇㄱㅏ	지위가 높고 교양이 있는 좋은 집안.
양기	ㅇㅑㅇㄱㅣ	햇볕의 따뜻한 기운.
양녀	ㅇㅑㅇㄴㅕ	자기가 낳지 않고 데려다가 기르는 딸.
양도	ㅇㅑㅇㄷㅗ	권리나 재산, 물건 등을 남에게 넘겨줌. 또는 그런 일.
양모	ㅇㅑㅇㅁㅗ	따뜻하여 겨울옷에 많이 사용되는, 양의 털.
양보	ㅇㅑㅇㅂㅗ	다른 사람을 위해 자리나 물건 등을 내주거나 넘겨줌.
양부	ㅇㅑㅇㅂㅜ	양자가 됨으로써 생긴 아버지.
양서	ㅇㅑㅇㅅㅓ	내용이 교훈적이거나 건전한 책.
양수	ㅇㅑㅇㅅㅜ	자궁 속에서 태아를 보호하는 역할을 하는 액체.
양자	ㅇㅑㅇㅈㅏ	서로 관련이 있는 두 사람이나 두 개의 물건.
양조	ㅇㅑㅇㅈㅗ	술이나 간장 등을 담가서 만듦.
양주	ㅇㅑㅇㅈㅜ	위스키나 코냑 등과 같이 서양에서 직접 들여왔거나 서양식으로 만든 술.
양지	ㅇㅑㅇㅈㅣ	볕이 들어 밝고 따뜻한 곳.
양초	ㅇㅑㅇㅊㅗ	적당한 온도에서 녹는 고체를 녹인 후 틀에 붓고 가운데 심지를 넣어 다시 굳힌, 불을 밝히는 데 쓰는 서양식 초.
양치	ㅇㅑㅇㅊㅣ	이를 닦고 물로 입 안을 씻어 냄.
양파	ㅇㅑㅇㅍㅏ	모양은 둥글고 매운맛과 특이한 향기가 있는 채소.
양호	ㅇㅑㅇㅎㅗ	학교 등의 시설에서 사람들의 건강과 위생을 살피고 돌봄.
얘기	ㅇㅑㅣㄱㅣ	어떠한 사실이나 상태, 현상, 경험, 생각 등에 관해 누군가에게 하는 말.
어간	ㅇㅓㄱㅏㄴ	동사나 형용사가 활용할 때에 변하지 않는 부분.
어감	ㅇㅓㄱㅏㅁ	말소리나 말투에서 느껴지는 느낌.
어근	ㅇㅓㄱㅡㄴ	단어를 분석할 때 실질적인 의미를 담고 있는 중심이 되는 부분.
어둠	ㅇㅓㄷㅜㅁ	어두운 상태나 어두운 때.
어록	ㅇㅓㄹㅗㄱ	훌륭하고 유명한 사람의 말을 모아 놓은 기록이나 책.
어뢰	ㅇㅓㄹㅗㅣ	물속에서 폭발하여 적의 배를 부수는, 물고기 모양으로 생긴 폭탄.
어른	ㅇㅓㄹㅡㄴ	다 자란 사람.
어림	ㅇㅓㄹㅣㅁ	짐작하여 대강 헤아림. 또는 그런 셈이나 짐작.
어멈	ㅇㅓㅁㅓㅁ	(조금 대접하는 말로) 자식이 있는 여자를 이르거나 부르는 말.
어명	ㅇㅓㅁㅕㅇ	임금이 내리는 명령.
어묵	ㅇㅓㅁㅜㄱ	생선의 살을 으깨어 소금, 밀가루 등을 넣고 반죽해서 익힌 음식.
어민	ㅇㅓㅁㅣㄴ	물고기를 잡는 일을 직업으로 하는 사람.
어법	ㅇㅓㅂㅓㅂ	말의 일정한 법칙.
어선	ㅇㅓㅅㅓㄴ	그물 등으로 물고기를 잡는 데 사용하는 배.
어순	ㅇㅓㅅㅜㄴ	한 문장 안에서 주어, 목적어, 서술어 등의 문장 성분이 나오는 순서.
어안	ㅇㅓㅇㅏㄴ	일이 너무 뜻밖이어서 말을 못하고 있는 혀 안.
어업	ㅇㅓㅇㅓㅂ	이익을 얻기 위해 물고기, 조개, 김, 미역 등을 잡거나 기르는 산업. 또는 그런 직업.
어용	ㅇㅓㅇㅛㅇ	(낮잡아 이르는 말로) 자신의 이익을 위하여 권력자나 권력 기관을 좇아 행동하는 것.
어육	ㅇㅓㅇㅠㄱ	생선의 고기.
어음	ㅇㅓㅇㅡㅁ	일정한 금액을 일정한 날짜와 장소에서 지불할 것을 약속하거나 다른 사람에게 그 지급을 맡기는 유가 증권.
어장	ㅇㅓㅈㅏㅇ	고기잡이를 하는 곳.
어절	ㅇㅓㅈㅓㄹ	문장을 구성하고 있는 각각의 마디.
어제	ㅇㅓㅈㅓㅣ	오늘의 하루 전날.
어족	ㅇㅓㅈㅗㄱ	고등어, 참치, 상어처럼 주로 몸이 비늘로 덮여 있으며, 물속에 살면서 지느러미로 헤엄을 치고 아가미로 숨을 쉬는 동물.
어종	ㅇㅓㅈㅗㅇ	물고기의 종류.
어촌	ㅇㅓㅊㅗㄴ	물고기를 잡아 생활하는 사람들이 모여 사는 바닷가 마을.
어폐	ㅇㅓㅍㅕㅣ	말을 적절하지 않게 써서 일어나는 오해나 잘못.
어필	ㅇㅓㅍㅣㄹ	흥미를 일으키거나 매력을 드러내어 사람의 마음을 끎.
어학	ㅇㅓㅎㅏㄱ	언어를 연구하는 학문.
어항	ㅇㅓㅎㅏㅇ	물고기를 넣어 기르는 유리로 된 통.
어휘	ㅇㅓㅎㅜㅣ	일정한 범위에서 쓰이는 낱말의 수. 또는 그런 낱말 전체.
억류	ㅇㅓㄱㄹㅠ	강제로 머무르게 함.
억수	ㅇㅓㄱㅅㅜ	물이 쏟아지듯이 세차게 많이 내리는 비.
억지	ㅇㅓㄱㅈㅣ	잘 안될 일을 무리하게 해내려는 고집.
언니	ㅇㅓㄴㄴㅣ	여자가 형제나 친척 형제들 중에서 자기보다 나이가 많은 여자를 이르거나 부르는 말.
언도	ㅇㅓㄴㄷㅗ	법정에서 재판장이 판결을 알림.
언사	ㅇㅓㄴㅅㅏ	말이나 말씨.
언어	ㅇㅓㄴㅇㅓ	생각이나 느낌 등을 나타내거나 전달하는 음성이나 문자 등의 수단. 또는 그 체계.
얼마	ㅇㅓㄹㅁㅏ	잘 모르는 수량, 값, 정도.
엄두	ㅇㅓㅁㄷㅜ	감히 무엇을 하려는 마음.
엄마	ㅇㅓㅁㅁㅏ	격식을 갖추지 않아도 되는 상황에서 어머니를 이르거나 부르는 말.
엄수	ㅇㅓㅁㅅㅜ	시간이나 약속, 명령 등을 반드시 지킴.
엄지	ㅇㅓㅁㅈㅣ	엄지손가락이나 엄지발가락.
엄포	ㅇㅓㅁㅍㅗ	실속 없이 괜한 큰소리로 남을 위협함.
업무	ㅇㅓㅂㅁㅜ	직장 등에서 맡아서 하는 일.
업소	ㅇㅓㅂㅅㅗ	규모가 작은 사업이나 장사를 하는 곳.
업자	ㅇㅓㅂㅈㅏ	사업을 직접 경영하는 사람.
업주	ㅇㅓㅂㅈㅜ	업소의 주인.
에러	ㅇㅓㅣㄹㅓ	틀리거나 잘못된 점. 또는 조심하지 않아 잘못되게 하는 행위.
에미	ㅇㅓㅣㅁㅣ	→ 어미 1
여건	ㅇㅕㄱㅓㄴ	이미 주어진 조건.
여걸	ㅇㅕㄱㅓㄹ	성격이 활달하고 용기가 있어 사회적으로 활발하게 활동하는 여자.
여경	ㅇㅕㄱㅕㅇ	여자 경찰관.
여공	ㅇㅕㄱㅗㅇ	공장에서 일하는 여자.
여과	ㅇㅕㄱㅗㅏ	액체 속에 들어 있는 알갱이나 가라앉은 물질을 걸러 내는 일.
여군	ㅇㅕㄱㅜㄴ	여자 군인. 또는 여자 군인들로 이루어진 군대.
여념	ㅇㅕㄴㅕㅁ	어떤 일에 대한 생각 이외의 다른 생각.
여담	ㅇㅕㄷㅏㅁ	이야기하는 주제에서 벗어난 흥미 위주의 다른 이야기.
여당	ㅇㅕㄷㅏㅇ	정당 정치에서, 대통령을 내거나 의회에서 의석을 가장 많이 차지하고 있는 당.
여대	ㅇㅕㄷㅏㅣ	‘여자 대학’을 줄여 이르는 말.
여독	ㅇㅕㄷㅗㄱ	여행으로 생긴 피로.
여럿	ㅇㅕㄹㅓㅅ	여러 개.
여력	ㅇㅕㄹㅕㄱ	어떤 일을 하고 난 뒤 또 다른 일을 할 수 있을 만큼 남아 있는 힘이나 능력.
여론	ㅇㅕㄹㅗㄴ	한 사회의 사람들이 공통적으로 가지고 있는 의견.
여름	ㅇㅕㄹㅡㅁ	네 계절 중의 하나로 봄과 가을 사이의 더운 계절.
여명	ㅇㅕㅁㅕㅇ	날이 밝아 올 때 희미하게 비치는 빛. 또는 그 무렵.
여물	ㅇㅕㅁㅜㄹ	소나 말의 먹이로 쓰려고 짚이나 풀을 말려서 썬 것.
여벌	ㅇㅕㅂㅓㄹ	당장 쓰지는 않지만 앞으로 쓸 것을 대비하여 미리 준비해 놓는 물건.
여분	ㅇㅕㅂㅜㄴ	어떤 양을 채우고 남은 부분.
여상	ㅇㅕㅅㅏㅇ	'여자 상업 고등학교'를 줄여 이르는 말.
여성	ㅇㅕㅅㅓㅇ	어른이 되어 아이를 낳을 수 있는 여자.
여세	ㅇㅕㅅㅓㅣ	어떤 일을 하고 난 뒤 또 다른 일을 할 수 있을 만큼 남아 있는 능력이나 기세.
여승	ㅇㅕㅅㅡㅇ	여자 승려.
여식	ㅇㅕㅅㅣㄱ	여자인 자식.
여신	ㅇㅕㅅㅣㄴ	여성인 신.
여염	ㅇㅕㅇㅕㅁ	백성들이 많이 모여 사는 마을.
여운	ㅇㅕㅇㅜㄴ	어떤 일이 끝난 다음에도 남아 있는 느낌이나 분위기.
여울	ㅇㅕㅇㅜㄹ	강이나 바다 등의 바닥이 얕거나 폭이 좁아 물이 세게 흐르는 곳.
여인	ㅇㅕㅇㅣㄴ	어른인 여자.
여장	ㅇㅕㅈㅏㅇ	남자가 여자처럼 얼굴과 옷차림 등을 꾸밈.
여정	ㅇㅕㅈㅓㅇ	여행을 할 때 느끼는 외롭고 울적한 감정.
여죄	ㅇㅕㅈㅗㅣ	주된 죄 이외에 남아 있는 또 다른 죄.
여중	ㅇㅕㅈㅜㅇ	‘여자 중학교’를 줄여 이르는 말.
여진	ㅇㅕㅈㅣㄴ	큰 지진이 일어난 다음에 일어나는 작은 지진.
여체	ㅇㅕㅊㅓㅣ	여성의 몸.
여탕	ㅇㅕㅌㅏㅇ	대중목욕탕에서 여자들이 목욕하는 곳.
여한	ㅇㅕㅎㅏㄴ	풀지 못하고 남은 한.
여흥	ㅇㅕㅎㅡㅇ	모임이나 연회가 끝난 뒤에 흥이 나도록 곁들이는 오락이나 연예.
역기	ㅇㅕㄱㄱㅣ	역도나 근육 단련 훈련을 할 때 쓰는, 쇠막대기 양쪽에 무거운 쇳덩이가 달린 운동 기구.
역도	ㅇㅕㄱㄷㅗ	누가 더 무거운 역기를 들어 올리는지 겨루는 경기.
역류	ㅇㅕㄱㄹㅠ	액체나 기체 등이 거꾸로 거슬러 오르거나 흐름.
역사	ㅇㅕㄱㅅㅏ	인간 사회가 시간이 지남에 따라 흥하고 망하면서 변해 온 과정. 또는 그 기록.
역서	ㅇㅕㄱㅅㅓ	한 해 동안의 천체의 운동이나 절기, 기상 변화 등을 날의 순서에 따라 적은 책.
역주	ㅇㅕㄱㅈㅜ	번역과 주석.
연가	ㅇㅕㄴㄱㅏ	직장에서 직원들에게 일 년에 일정한 기간을 쉬도록 해 주는 휴가.
연고	ㅇㅕㄴㄱㅗ	피부에 발라서 병이나 상처를 치료하는 약.
연구	ㅇㅕㄴㄱㅜ	어떤 사물이나 일에 관련된 사실을 밝히기 위해 그에 대해 자세히 조사하고 분석하는 일.
연기	ㅇㅕㄴㄱㅣ	정해진 시기를 뒤로 미룸.
연도	ㅇㅕㄴㄷㅗ	어떤 일이 일어난 시기를 말하기 위해 편의상 구분한 일 년의 기간.
연두	ㅇㅕㄴㄷㅜ	새해의 시작.
연료	ㅇㅕㄴㄹㅛ	태워서 빛이나 열을 내거나 기계를 움직이는 에너지를 얻을 수 있는 물질.
연루	ㅇㅕㄴㄹㅜ	다른 사람이 저지른 범죄에 관련됨.
연리	ㅇㅕㄴㄹㅣ	일 년을 단위로 계산하는 이자나 이율.
연마	ㅇㅕㄴㅁㅏ	금속이나 돌 등을 갈고 닦아 표면을 반질반질하게 함.
연모	ㅇㅕㄴㅁㅗ	이성을 사랑하여 몹시 그리워함.
연보	ㅇㅕㄴㅂㅗ	사람이 평생 동안 지낸 일을 시간 순서대로 적은 글.
연비	ㅇㅕㄴㅂㅣ	자동차가 일정한 양의 연료를 써서 움직이는 거리.
연사	ㅇㅕㄴㅅㅏ	연설하는 사람.
연서	ㅇㅕㄴㅅㅓ	한 문서에 두 사람 이상이 잇따라 서명함.
연소	ㅇㅕㄴㅅㅗ	물질이 산소와 결합하여 열과 빛을 내는 현상.
연수	ㅇㅕㄴㅅㅜ	지식이나 기술 등을 배우고 연구함.
연시	ㅇㅕㄴㅅㅣ	잘 익어 물렁물렁한 감.
연어	ㅇㅕㄴㅇㅓ	두 개 이상의 단어가 결합하여 의미적으로 하나의 단위를 이루는 말.
연유	ㅇㅕㄴㅇㅠ	우유를 진공 상태에서 농축한 것.
연주	ㅇㅕㄴㅈㅜ	악기를 다루어 음악을 들려줌.
연차	ㅇㅕㄴㅊㅏ	나이나 햇수의 차례.
연초	ㅇㅕㄴㅊㅗ	새해의 처음 무렵.
연타	ㅇㅕㄴㅌㅏ	계속 이어서 치거나 때림.
연하	ㅇㅕㄴㅎㅏ	자기보다 나이가 적음. 또는 그런 사람.
연호	ㅇㅕㄴㅎㅗ	이름이나 구호 등을 계속 외침.
연휴	ㅇㅕㄴㅎㅠ	휴일이 이틀 이상 계속됨. 또는 그 휴일.
열거	ㅇㅕㄹㄱㅓ	여러 가지 예나 사실 등을 하나하나 죽 늘어놓음.
열기	ㅇㅕㄹㄱㅣ	뜨거운 기운.
열녀	ㅇㅕㄹㄴㅕ	남편에 대한 절개를 지킨 여자.
열도	ㅇㅕㄹㄷㅗ	길게 줄지어 있는 여러 개의 섬.
열무	ㅇㅕㄹㅁㅜ	잎이 연해서 뿌리보다 잎을 주로 이용하여 김치 등을 담그는 어린 무.
열부	ㅇㅕㄹㅂㅜ	죽은 아내를 사랑하는 마음을 굳게 지켜 다시 결혼하지 않은 남자.
열사	ㅇㅕㄹㅅㅏ	나라를 위해 싸우다 목숨을 바친 사람.
열차	ㅇㅕㄹㅊㅏ	여러 개의 칸을 길게 이어 놓은 기차나 전철.
염두	ㅇㅕㅁㄷㅜ	마음의 속.
염려	ㅇㅕㅁㄹㅕ	앞으로 생길 일에 대해 불안해하고 걱정함. 또는 그런 걱정.
염료	ㅇㅕㅁㄹㅛ	옷감 등에 색깔을 들이는 물질.
염소	ㅇㅕㅁㅅㅗ	소보다 작고 뿔이 있으며 몸의 색깔은 갈색, 검은색, 흰색 등인, 가축으로 기르는 동물.
염주	ㅇㅕㅁㅈㅜ	불교에서 아미타불을 부르거나 불경을 욀 때 손으로 돌리며 횟수를 세는, 작은 알들이 둥글게 꿰어져 있는 도구.
염치	ㅇㅕㅁㅊㅣ	체면을 차릴 줄 알거나 부끄러움을 아는 마음.
엽기	ㅇㅕㅂㄱㅣ	비정상적이고 괴상한 일이나 사물에 흥미를 느끼고 찾아다님.
엽서	ㅇㅕㅂㅅㅓ	보내는 사람과 받는 사람의 주소, 편지의 내용을 한 장에 적어서 우편으로 보낼 수 있도록 만들어진 용지.
영구	ㅇㅕㅇㄱㅜ	시간이 오래 지나도 변하지 않고 무한히 계속됨.
영리	ㅇㅕㅇㄹㅣ	재산상의 이익을 얻음.
영미	ㅇㅕㅇㅁㅣ	영국과 미국.
영사	ㅇㅕㅇㅅㅏ	외국에서 있으면서 자기 나라의 무역에 관한 일과 외국에 있는 자기 나라 국민을 보호하는 일을 하는 공무원.
영서	ㅇㅕㅇㅅㅓ	강원도에서 대관령 서쪽에 있는 지역.
영시	ㅇㅕㅇㅅㅣ	영어로 쓴 시.
영아	ㅇㅕㅇㅇㅏ	젖을 먹는 아주 어린 아이.
영어	ㅇㅕㅇㅇㅓ	영국과 미국 등 세계적으로 가장 널리 쓰이는 언어.
영주	ㅇㅕㅇㅈㅜ	한곳에서 오래 삶.
영지	ㅇㅕㅇㅈㅣ	중세 유럽의 봉건 제도에서 영주가 지배권을 가지고 영향력을 미치는 지역.
영토	ㅇㅕㅇㅌㅗ	한 국가의 땅.
영하	ㅇㅕㅇㅎㅏ	섭씨 0도 이하인 온도.
예고	ㅇㅕㅣㄱㅗ	어떤 일이 일어나기 전에 미리 알림.
예보	ㅇㅕㅣㅂㅗ	앞으로 일어날 일을 미리 알림. 또는 그런 보도.
예비	ㅇㅕㅣㅂㅣ	필요할 때 쓰기 위하여 미리 마련하거나 갖추어 놓음.
예사	ㅇㅕㅣㅅㅏ	보통 흔하게 있는 일.
예수	ㅇㅕㅣㅅㅜ	기독교의 창시자(?기원전 4~?서기 30). 처녀 마리아에게 성령으로 잉태되어 태어났으며 복음을 전파하다가 십자가에 못 박혀 죽었다. 죽은 지 사흘 만에 부활하여 그 뒤 승천하였다고 한다.
예시	ㅇㅕㅣㅅㅣ	예를 들어 보임.
예우	ㅇㅕㅣㅇㅜ	예의를 지켜 정중하게 대함.
예치	ㅇㅕㅣㅊㅣ	돈이나 물건을 은행이나 기관 등에 맡겨 둠.
오감	ㅇㅗㄱㅏㅁ	눈, 귀, 코, 혀, 피부로 느끼는 다섯 가지 감각.
오경	ㅇㅗㄱㅕㅇ	하룻밤을 다섯으로 나눈 시각.
오곡	ㅇㅗㄱㅗㄱ	다섯 가지 중요한 곡식.
오금	ㅇㅗㄱㅡㅁ	무릎을 구부렸을 때 오목하게 들어간 부분.
오늘	ㅇㅗㄴㅡㄹ	지금 지나가고 있는 이날.
오답	ㅇㅗㄷㅏㅂ	잘못된 대답을 함. 또는 그 대답.
오독	ㅇㅗㄷㅗㄱ	잘못 읽거나 틀리게 읽음.
오동	ㅇㅗㄷㅗㅇ	높이는 15m 정도이고 잎이 아주 크고 둥근, 가구나 악기를 만드는 데에 주로 쓰이는 나무.
오락	ㅇㅗㄹㅏㄱ	여유 시간에 기분을 즐겁게 하기 위하여 하는 여러 가지 놀이.
오만	ㅇㅗㅁㅏㄴ	잘난 체하고 건방짐. 또는 그런 태도나 행동.
오명	ㅇㅗㅁㅕㅇ	실수나 잘못 등을 해서 더러워지고 부끄럽게 된 이름이나 명예.
오물	ㅇㅗㅁㅜㄹ	지저분하고 더러운 쓰레기나 대소변 같은 배설물.
오발	ㅇㅗㅂㅏㄹ	총이나 대포 등을 잘못 쏨.
오복	ㅇㅗㅂㅗㄱ	오래 살고, 재산이 많고, 건강하고, 덕이 많고, 편안히 죽는, 유교에서 말하는 다섯 가지의 복.
오븐	ㅇㅗㅂㅡㄴ	위, 아래, 양옆에서 열을 가해 음식을 익히는 조리 기구.
오빠	ㅇㅗㅂㅂㅏ	여자가 형제나 친척 형제들 중에서 자기보다 나이가 많은 남자를 이르거나 부르는 말.
오산	ㅇㅗㅅㅏㄴ	잘못 계산함. 또는 잘못된 계산.
오심	ㅇㅗㅅㅣㅁ	잘못 심판함. 또는 그런 심판.
오역	ㅇㅗㅇㅕㄱ	잘못 번역함. 또는 잘못된 번역.
오열	ㅇㅗㅇㅕㄹ	목메어 욺. 또는 목메어 우는 울음.
오염	ㅇㅗㅇㅕㅁ	더러운 상태가 됨.
오욕	ㅇㅗㅇㅛㄱ	명예를 더럽혀 부끄럽고 수치스럽게 만듦.
오용	ㅇㅗㅇㅛㅇ	잘못 사용함.
오인	ㅇㅗㅇㅣㄴ	잘못 생각하거나 잘못 봄.
오입	ㅇㅗㅇㅣㅂ	남자가 자기 아내가 아닌 다른 여자와 성관계를 가짐.
오장	ㅇㅗㅈㅏㅇ	간장, 심장, 비장, 폐장, 신장의 다섯 가지 내장.
오전	ㅇㅗㅈㅓㄴ	아침부터 낮 열두 시까지의 동안.
오점	ㅇㅗㅈㅓㅁ	더러운 점.
오존	ㅇㅗㅈㅗㄴ	특유의 냄새가 나며 표백제, 살균제 등으로 쓰는 푸른빛의 기체.
오줌	ㅇㅗㅈㅜㅁ	혈액 속의 노폐물과 수분이 요도를 통하여 몸 밖으로 배출되는, 누렇고 지린내가 나는 액체.
오진	ㅇㅗㅈㅣㄴ	병을 잘못 진단하는 일. 또는 그런 진단.
오찬	ㅇㅗㅊㅏㄴ	보통 때보다 잘 차려서 손님을 대접하는 점심 식사.
오촌	ㅇㅗㅊㅗㄴ	부모님의 사촌이나 사촌의 자식과의 친족 관계. 또는 그런 관계에 있는 사람.
오판	ㅇㅗㅍㅏㄴ	잘못 보거나 잘못 판단함. 또는 잘못된 판단.
오한	ㅇㅗㅎㅏㄴ	몸에 열이 나면서 춥고 떨리는 증상.
오해	ㅇㅗㅎㅏㅣ	어떤 것을 잘못 알거나 잘못 해석함.
옥고	ㅇㅗㄱㄱㅗ	(높이는 말로) 다른 사람의 훌륭한 원고.
옥니	ㅇㅗㄱㄴㅣ	안으로 오그라져 난 이.
옥사	ㅇㅗㄱㅅㅏ	죄를 짓고 감옥에 갇혀 살다가 감옥에서 죽음.
옥토	ㅇㅗㄱㅌㅗ	양분이 많아 농작물이 잘 자라는 땅.
온기	ㅇㅗㄴㄱㅣ	따뜻한 기운.
온도	ㅇㅗㄴㄷㅗ	따뜻하고 차가운 정도. 또는 그것을 나타내는 수치.
온수	ㅇㅗㄴㅅㅜ	따뜻한 물.
온유	ㅇㅗㄴㅇㅠ	성격이나 태도 등이 따뜻하고 부드러움.
올무	ㅇㅗㄹㅁㅜ	새나 짐승을 잡는 데 쓰는 고리 모양의 장치.
올벼	ㅇㅗㄹㅂㅕ	보통 익는 시기보다 더 일찍 익는 벼.
옹기	ㅇㅗㅇㄱㅣ	진흙으로 만들어 구운 그릇.
옹호	ㅇㅗㅇㅎㅗ	편들고 도움을 주어 지킴.
외가	ㅇㅗㅣㄱㅏ	어머니의 친정.
외교	ㅇㅗㅣㄱㅛ	다른 나라와 정치적, 경제적, 문화적 관계를 맺는 일.
외도	ㅇㅗㅣㄷㅗ	올바르지 않은 일.
외모	ㅇㅗㅣㅁㅗ	사람의 겉으로 보이는 모양.
외무	ㅇㅗㅣㅁㅜ	다른 나라와 정치적, 경제적, 문화적 관계를 맺는 일에 관한 사무.
외부	ㅇㅗㅣㅂㅜ	밖이 되는 부분.
외서	ㅇㅗㅣㅅㅓ	다른 나라의 글로 쓰인 책.
외야	ㅇㅗㅣㅇㅑ	야구에서 본루, 1루, 2루, 3루를 연결한 선 뒤쪽의 파울 라인 안의 지역.
외자	ㅇㅗㅣㅈㅏ	‘외국 자본’을 줄여 이르는 말.
외조	ㅇㅗㅣㅈㅗ	아내가 사회적인 활동을 잘할 수 있도록 남편이 도와줌.
외주	ㅇㅗㅣㅈㅜ	자기 회사의 일부 작업을 다른 회사에 맡김. 또는 그런 일.
외지	ㅇㅗㅣㅈㅣ	자기가 사는 곳 바깥의 동네나 지역.
외투	ㅇㅗㅣㅌㅜ	점퍼나 코트처럼 추위를 막기 위해 겉에 입는 옷.
외표	ㅇㅗㅣㅍㅛ	사람의 겉모양.
외피	ㅇㅗㅣㅍㅣ	과일이나 채소 등의 겉을 둘러싸고 있는 것.
요강	ㅇㅛㄱㅏㅇ	놋쇠나 사기 등으로 만들어 방에 두고 오줌을 누는 그릇.
요건	ㅇㅛㄱㅓㄴ	급하고 중요한 일이나 의논할 것.
요괴	ㅇㅛㄱㅗㅣ	사람에게 해를 끼치는 귀신.
요금	ㅇㅛㄱㅡㅁ	시설을 쓰거나 구경을 하는 값으로 내는 돈.
요담	ㅇㅛㄷㅏㅁ	요번의 바로 뒤에 이어져 오는 때나 차례.
요동	ㅇㅛㄷㅗㅇ	흔들려 움직임. 또는 흔들어 움직임.
요란	ㅇㅛㄹㅏㄴ	어수선하고 시끄러움.
요람	ㅇㅛㄹㅏㅁ	아기를 태우고 흔들어 놀게 하거나 재우는, 바구니처럼 생긴 물건.
요량	ㅇㅛㄹㅑㅇ	앞으로 할 일을 잘 계산해 생각함. 또는 그런 생각.
요령	ㅇㅛㄹㅕㅇ	가장 중요하고 핵심이 되는 줄거리.
요망	ㅇㅛㅁㅏㅇ	간사하고 영악함.
요목	ㅇㅛㅁㅗㄱ	중요한 항목.
요물	ㅇㅛㅁㅜㄹ	괴상하고 기분 나쁜 것.
요번	ㅇㅛㅂㅓㄴ	곧 돌아오거나 이제 막 지나간 차례.
요법	ㅇㅛㅂㅓㅂ	병을 치료하는 방법.
요새	ㅇㅛㅅㅏㅣ	얼마 전부터 이제까지의 매우 짧은 동안.
요술	ㅇㅛㅅㅜㄹ	초자연적인 능력으로, 또는 사람의 눈을 속여 놀라운 일을 행함. 또는 그런 기술.
요식	ㅇㅛㅅㅣㄱ	반드시 따라야 하는 일정한 규정이나 방식.
요약	ㅇㅛㅇㅑㄱ	말이나 글에서 중요한 것을 골라 짧게 만듦.
요양	ㅇㅛㅇㅑㅇ	편안히 쉬면서 몸을 보살피고 병을 치료함.
요염	ㅇㅛㅇㅕㅁ	상대방의 정신을 흐리게 할 만큼 매우 아름다움.
요율	ㅇㅛㅇㅠㄹ	요금의 정도나 비율.
요의	ㅇㅛㅇㅡㅣ	오줌이 마려운 느낌.
요인	ㅇㅛㅇㅣㄴ	사물이나 사건 등이 성립되는 중요한 원인.
요일	ㅇㅛㅇㅣㄹ	일주일을 이루는 각각의 날.
요절	ㅇㅛㅈㅓㄹ	젊은 나이에 죽음.
요점	ㅇㅛㅈㅓㅁ	가장 중요하고 중심이 되는 사항.
요정	ㅇㅛㅈㅓㅇ	서양의 전설이나 동화에 나오는, 사람의 모습을 하고 신비로운 힘을 지닌 초자연적인 존재.
요즘	ㅇㅛㅈㅡㅁ	아주 가까운 과거부터 지금까지의 사이.
요직	ㅇㅛㅈㅣㄱ	중요한 직책이나 직위.
요철	ㅇㅛㅊㅓㄹ	오목함과 볼록함.
요청	ㅇㅛㅊㅓㅇ	필요한 일을 해 달라고 부탁함. 또는 그런 부탁.
요체	ㅇㅛㅊㅓㅣ	중요한 점.
요충	ㅇㅛㅊㅜㅇ	교통이나 상업, 군사적인 면에서 아주 중요한 지역.
요통	ㅇㅛㅌㅗㅇ	허리와 엉덩이 부위가 아픈 증상.
욕구	ㅇㅛㄱㄱㅜ	무엇을 얻거나 무슨 일을 하기를 바라는 것.
욕조	ㅇㅛㄱㅈㅗ	목욕을 하기 위해 물을 담는 큰 통.
용구	ㅇㅛㅇㄱㅜ	어떤 일을 하거나 물건을 만드는 데 쓰는 도구.
용기	ㅇㅛㅇㄱㅣ	겁이 없고 씩씩한 기운.
용도	ㅇㅛㅇㄷㅗ	쓰이는 곳이나 목적.
용모	ㅇㅛㅇㅁㅗ	사람의 얼굴 모양.
용무	ㅇㅛㅇㅁㅜ	해야 할 일.
용사	ㅇㅛㅇㅅㅏ	용감하고 씩씩한 사람.
용서	ㅇㅛㅇㅅㅓ	잘못이나 죄에 대하여 꾸중을 하거나 벌을 주지 않고 너그럽게 덮어 줌.
용수	ㅇㅛㅇㅅㅜ	어떤 일을 이루기 위해 수단을 부림. 또는 그 수단.
용어	ㅇㅛㅇㅇㅓ	어떤 분야에서 전문적으로 사용하는 말.
용지	ㅇㅛㅇㅈㅣ	어떤 일에 쓰는 종이.
우국	ㅇㅜㄱㅜㄱ	나라에 관한 일을 불안해하고 걱정함.
우군	ㅇㅜㄱㅜㄴ	자기와 같은 편인 군대.
우뇌	ㅇㅜㄴㅗㅣ	뇌의 오른쪽 부분.
우대	ㅇㅜㄷㅏㅣ	특별히 잘 대우함. 또는 그런 대우.
우동	ㅇㅜㄷㅗㅇ	면발이 굵은 국수. 또는 그것을 삶아서 국물과 함께 요리한 음식.
우둔	ㅇㅜㄷㅜㄴ	어리석고 행동이 느림.
우등	ㅇㅜㄷㅡㅇ	우수한 등급.
우량	ㅇㅜㄹㅑㅇ	품질이나 상태가 우수하고 좋음.
우레	ㅇㅜㄹㅓㅣ	대기 중에서 매우 큰 소리와 번개가 함께 나타나는 현상.
우롱	ㅇㅜㄹㅗㅇ	남을 어리석고 하찮게 여겨 함부로 대하거나 놀림.
우뢰	ㅇㅜㄹㅗㅣ	→ 우레
우문	ㅇㅜㅁㅜㄴ	어리석은 질문.
우물	ㅇㅜㅁㅜㄹ	물을 긷기 위해 땅을 파서 지하수가 모이도록 한 곳.
우민	ㅇㅜㅁㅣㄴ	어리석은 백성.
우박	ㅇㅜㅂㅏㄱ	큰 물방울들이 공중에서 찬 기운을 만나 얼음이 되어 떨어지는 덩어리.
우발	ㅇㅜㅂㅏㄹ	어떤 일이 우연히 일어남. 또는 우연히 일어난 일.
우방	ㅇㅜㅂㅏㅇ	서로 사이가 좋은 나라.
우범	ㅇㅜㅂㅓㅁ	범죄가 일어날 우려가 있음.
우산	ㅇㅜㅅㅏㄴ	긴 막대 위에 지붕 같은 막을 펼쳐서 비가 올 때 손에 들고 머리 위를 가리는 도구.
우상	ㅇㅜㅅㅏㅇ	나무, 돌, 흙 등으로 신이나 부처, 사람의 모양을 만든 것.
우선	ㅇㅜㅅㅓㄴ	다른 것에 앞서 특별하게 대우함.
우성	ㅇㅜㅅㅓㅇ	서로 다른 품종을 교배했을 때 우선적으로 나타나는 유전적 성질.
우세	ㅇㅜㅅㅓㅣ	남보다 힘이 강하거나 실력이 나음. 또는 그 힘이나 실력.
우송	ㅇㅜㅅㅗㅇ	우편으로 보냄.
우승	ㅇㅜㅅㅡㅇ	경기나 시합에서 상대를 모두 이겨 일 위를 차지함.
우애	ㅇㅜㅇㅏㅣ	형제 또는 친구 사이의 정과 사랑.
우엉	ㅇㅜㅇㅓㅇ	7월에 검은 자주색 또는 흰색의 꽃이 피며 뿌리와 어린잎을 먹는 풀. 또는 그 뿌리.
우연	ㅇㅜㅇㅕㄴ	마땅한 이유 없이 어쩌다가 일어난 일.
우열	ㅇㅜㅇㅕㄹ	나음과 못함.
우울	ㅇㅜㅇㅜㄹ	걱정 등으로 마음이 답답하여 활발한 기운이 없음.
우위	ㅇㅜㅇㅜㅣ	다른 사람보다 뛰어난 위치나 수준.
우의	ㅇㅜㅇㅡㅣ	친구나 형제 또는 두 집단 사이의 친밀한 감정과 의리.
우익	ㅇㅜㅇㅣㄱ	새나 비행기 등의 오른쪽 날개.
우정	ㅇㅜㅈㅓㅇ	친구 사이의 정.
우중	ㅇㅜㅈㅜㅇ	비가 오는 가운데. 또는 비가 올 때.
우측	ㅇㅜㅊㅡㄱ	사람이 북쪽을 보고 있을 때 동쪽과 같은 쪽.
우편	ㅇㅜㅍㅕㄴ	사람이 북쪽을 보고 있을 때 동쪽과 같은 쪽. 오른쪽.
우화	ㅇㅜㅎㅗㅏ	동식물이나 사물을 주인공으로 하여 교훈과 풍자의 뜻을 나타내는 이야기.
우회	ㅇㅜㅎㅗㅣ	바로 가지 않고 돌아서 감.
운구	ㅇㅜㄴㄱㅜ	시체를 넣은 관을 운반함.
운무	ㅇㅜㄴㅁㅜ	구름과 안개.
운소	ㅇㅜㄴㅅㅗ	소리의 높낮이, 길이, 세기 등과 같이 단어의 뜻을 다르게 하는 데 관여하는 소리의 단위.
운수	ㅇㅜㄴㅅㅜ	인간의 힘으로는 바꿀 수 없는, 이미 정해져 있는 인간의 운명.
운치	ㅇㅜㄴㅊㅣ	은근하고 그윽한 멋이 있는 분위기.
운하	ㅇㅜㄴㅎㅏ	배가 다니거나 물을 끌어 쓸 수 있도록 육지에 파 놓은 물길.
운휴	ㅇㅜㄴㅎㅠ	자동차, 기차, 비행기, 배 등이 정해진 길을 다니며 일하지 않고 쉼.
울보	ㅇㅜㄹㅂㅗ	잘 우는 아이.
웅비	ㅇㅜㅇㅂㅣ	힘차게 뻗어 나감.
웹	ㅇㅜㅓㅣㅂ	동영상이나 음성 등의 여러 정보 매체를 이용하는 인터넷.
위기	ㅇㅜㅣㄱㅣ	위험한 고비. 위험해서 아슬아슬한 순간.
위도	ㅇㅜㅣㄷㅗ	지구 위의 위치를 가로로 나타내는 것.
위로	ㅇㅜㅣㄹㅗ	따뜻한 말이나 행동 등으로 괴로움을 덜어 주거나 슬픔을 달래 줌.
위조	ㅇㅜㅣㅈㅗ	남을 속이려고 물건이나 문서를 진짜처럼 만듦.
위주	ㅇㅜㅣㅈㅜ	무엇을 가장 중요한 것으로 삼음.
위치	ㅇㅜㅣㅊㅣ	일정한 곳에 자리를 차지함. 또는 그 자리.
위트	ㅇㅜㅣㅌㅡ	말이나 글을 재미있고 재치 있게 잘 구사하는 능력.
유감	ㅇㅠㄱㅏㅁ	마음에 남아 있는 섭섭하거나 불만스러운 느낌.
유격	ㅇㅠㄱㅕㄱ	몰래 기회를 보아 적을 기습적으로 공격하는 일.
유곡	ㅇㅠㄱㅗㄱ	산속의 깊은 골짜기.
유골	ㅇㅠㄱㅗㄹ	죽은 사람을 태우고 남은 뼈. 또는 무덤 속에서 나온 뼈.
유과	ㅇㅠㄱㅗㅏ	쌀가루나 밀가루 반죽을 일정한 모양으로 빚어서 기름에 튀긴 후에 꿀이나 조청을 바르고 튀밥, 깨 등을 입힌 한국의 전통 과자.
유괴	ㅇㅠㄱㅗㅣ	돈 등을 요구할 목적으로, 주로 아이를 속여서 꾀어냄.
유급	ㅇㅠㄱㅡㅂ	일을 한 대가로 받는 돈이 있음.
유난	ㅇㅠㄴㅏㄴ	상태나 성격, 행동 등이 보통과 아주 다름.
유년	ㅇㅠㄴㅕㄴ	나이가 어린 때.
유대	ㅇㅠㄷㅏㅣ	둘 이상을 서로 이어 주거나 결합하게 하는 것. 또는 그런 관계.
유독	ㅇㅠㄷㅗㄱ	독이 있어 해로움.
유동	ㅇㅠㄷㅗㅇ	액체나 전류 등이 흘러 움직임.
유람	ㅇㅠㄹㅏㅁ	여러 곳을 돌아다니며 구경함.
유랑	ㅇㅠㄹㅏㅇ	일정하게 자리를 잡고 사는 곳이 없이 이리저리 떠돌아다님.
유래	ㅇㅠㄹㅏㅣ	사물이나 일이 생겨남. 또는 그 사물이나 일이 생겨난 내력.
유럽	ㅇㅠㄹㅓㅂ	아시아의 서북쪽에 있는 육대주의 하나. 우랄산맥을 사이에 두고 아시아와 접해 있으며 프랑스, 독일, 이탈리아 등의 나라가 위치한다.
유력	ㅇㅠㄹㅕㄱ	힘이나 재산이 있음.
유령	ㅇㅠㄹㅕㅇ	죽은 사람의 혼령.
유례	ㅇㅠㄹㅕㅣ	같거나 비슷한 예.
유린	ㅇㅠㄹㅣㄴ	남의 권리나 인격을 마구 억누르거나 짓밟음.
유림	ㅇㅠㄹㅣㅁ	유학을 따르고 공부하는 무리.
유망	ㅇㅠㅁㅏㅇ	앞으로 잘될 것 같은 희망이나 가능성이 있음.
유명	ㅇㅠㅁㅕㅇ	이름이 널리 알려져 있음.
유목	ㅇㅠㅁㅗㄱ	소나 양과 같은 가축이 먹을 풀과 물을 찾아 옮겨 다니면서 삶.
유물	ㅇㅠㅁㅜㄹ	앞선 시대에 살았던 사람들이 후대에 남긴 물건.
유발	ㅇㅠㅂㅏㄹ	어떤 것이 원인이 되어 다른 사건이나 현상을 일어나게 함.
유방	ㅇㅠㅂㅏㅇ	젖을 내보내기 위한 기관으로 포유류의 가슴이나 배에 달려 있는 볼록한 부분.
유배	ㅇㅠㅂㅏㅣ	(옛날에) 죄인에게 형벌을 주어 먼 시골이나 섬으로 보냄.
유별	ㅇㅠㅂㅕㄹ	서로 다름이 있음.
유분	ㅇㅠㅂㅜㄴ	어떤 것에 묻어 있거나 섞여 있는 기름기.
유산	ㅇㅠㅅㅏㄴ	배 속에 있는 아기가 달이 차기 전에 죽어서 나옴.
유상	ㅇㅠㅅㅏㅇ	어떤 행위에 대해 보상이 있음.
유선	ㅇㅠㅅㅓㄴ	미리 설치된 전선을 통한 방송이나 통신 방법.
유성	ㅇㅠㅅㅓㅇ	기름의 성질. 또는 기름의 성질을 띤 물건.
유세	ㅇㅠㅅㅓㅣ	자랑할 만한 힘이나 재산 등의 세력.
유속	ㅇㅠㅅㅗㄱ	물 등의 액체가 흐르는 속도.
유숙	ㅇㅠㅅㅜㄱ	남의 집이나 잠을 잘 수 있게 마련된 시설에서 묵음.
유식	ㅇㅠㅅㅣㄱ	배워서 아는 것이 많음.
유신	ㅇㅠㅅㅣㄴ	낡은 제도나 체제를 고쳐 새롭게 함.
유실	ㅇㅠㅅㅣㄹ	물에 떠내려가서 없어짐.
유언	ㅇㅠㅇㅓㄴ	죽기 전에 말을 남김. 또는 그 말.
유업	ㅇㅠㅇㅓㅂ	조상으로부터 이어 온 사업.
유역	ㅇㅠㅇㅕㄱ	강의 영향을 받는 강의 주변 지역.
유예	ㅇㅠㅇㅕㅣ	일을 실행하지 못하고 망설임.
유용	ㅇㅠㅇㅛㅇ	쓸모가 있음.
유의	ㅇㅠㅇㅡㅣ	마음에 두고 조심하며 신경을 씀.
유익	ㅇㅠㅇㅣㄱ	이롭거나 도움이 될 만함.
유인	ㅇㅠㅇㅣㄴ	차나 비행기, 우주선 등에 그것을 작동하고 운전하는 사람이 있음.
유일	ㅇㅠㅇㅣㄹ	오직 하나만 있음.
유임	ㅇㅠㅇㅣㅁ	조직을 개편하거나 임기가 끝날 때 그 자리나 직위에 그대로 머무르거나 머무르게 함. 또는 그런 일.
유입	ㅇㅠㅇㅣㅂ	액체, 기체, 열 등이 흘러 들어옴.
유작	ㅇㅠㅈㅏㄱ	죽은 사람이 살아 있을 때 발표하지 않고 남긴 작품.
유적	ㅇㅠㅈㅓㄱ	남아 있는 역사적인 자취.
유전	ㅇㅠㅈㅓㄴ	석유가 나는 곳.
유족	ㅇㅠㅈㅗㄱ	죽은 사람의 남아 있는 가족.
유종	ㅇㅠㅈㅗㅇ	시작한 일에 끝이 있음.
유죄	ㅇㅠㅈㅗㅣ	잘못이나 죄가 있음.
유착	ㅇㅠㅊㅏㄱ	기관이나 사물 등이 서로 깊은 관계를 가지고 결합함.
유찰	ㅇㅠㅊㅏㄹ	경매나 경쟁 입찰 등에서 물건이나 일을 따낸 사람이 결정되지 않고 무효로 돌아감.
유채	ㅇㅠㅊㅏㅣ	물감을 기름에 풀어서 그림을 그리는 방법.
유출	ㅇㅠㅊㅜㄹ	한곳에 모여 있던 것이 밖으로 흘러 나감. 또는 흘려 내보냄.
유충	ㅇㅠㅊㅜㅇ	알에서 나와 다 자라지 않은 벌레.
유턴	ㅇㅠㅌㅓㄴ	자동차 등이 ‘U’ 자 모양으로 돌아 방향을 바꿈.
유통	ㅇㅠㅌㅗㅇ	공기 등이 막힘없이 흐름.
유품	ㅇㅠㅍㅜㅁ	죽은 사람이 살아 있을 때 사용하다 남긴 물건.
유학	ㅇㅠㅎㅏㄱ	외국에 머물러 살면서 공부함.
유한	ㅇㅠㅎㅏㄴ	일정한 한도나 한계가 있음.
유해	ㅇㅠㅎㅏㅣ	해로움이 있음.
유혈	ㅇㅠㅎㅕㄹ	어떤 사고나 사건으로 사람들이 피를 흘림. 또는 사람들이 흘린 피.
유형	ㅇㅠㅎㅕㅇ	볼 수 있거나 만질 수 있도록 일정한 모습을 갖추고 있음.
유혹	ㅇㅠㅎㅗㄱ	마음이 쏠리거나 잘못된 행동을 하도록 꾐.
유화	ㅇㅠㅎㅗㅏ	물감을 기름에 섞어서 그리는 서양식 그림.
유흥	ㅇㅠㅎㅡㅇ	술을 마시며 즐겁게 놂.
유희	ㅇㅠㅎㅡㅣ	장난을 치며 즐겁게 놂. 또는 그런 놀이.
육교	ㅇㅠㄱㄱㅛ	도로나 철로 위를 건너갈 수 있도록 만든 다리.
육로	ㅇㅠㄱㄹㅗ	땅 위로 난 길.
육류	ㅇㅠㄱㄹㅠ	사람이 먹을 수 있는 소, 돼지, 닭 등의 고기 종류.
육부	ㅇㅠㄱㅂㅜ	사람의 배 속에 있는 여섯 가지 내장 기관.
육수	ㅇㅠㄱㅅㅜ	고기를 삶은 국물.
육시	ㅇㅠㄱㅅㅣ	이미 죽은 사람의 시체를 꺼내 그 목을 베는 형벌을 가함.
육아	ㅇㅠㄱㅇㅏ	어린아이를 돌보고 기름.
육지	ㅇㅠㄱㅈㅣ	지구에서 물로 된 부분이 아닌 흙이나 돌로 된 부분.
육포	ㅇㅠㄱㅍㅗ	쇠고기를 얇게 썰어서 말린 것.
윤기	ㅇㅠㄴㄱㅣ	반들거리고 매끄러운 물체의 표면에서 나는 빛.
윤리	ㅇㅠㄴㄹㅣ	사람으로서 마땅히 지켜야 할 바람직한 행동 기준.
율무	ㅇㅠㄹㅁㅜ	밥을 지을 때 섞어 먹거나 가루를 내어 차로 마시거나 약으로 쓰는 곡물.
융기	ㅇㅠㅇㄱㅣ	높게 일어나 들뜸.
융자	ㅇㅠㅇㅈㅏ	은행 등의 금융 기관에서 돈을 빌려줌. 또는 그 돈.
은거	ㅇㅡㄴㄱㅓ	세상을 피해 숨어서 지냄.
은사	ㅇㅡㄴㅅㅏ	가르침을 받은 은혜로운 선생님.
은어	ㅇㅡㄴㅇㅓ	어떤 집단이나 계층의 사람들이 다른 사람들이 알아듣지 못하도록 자기들끼리만 사용하는 말.
은유	ㅇㅡㄴㅇㅠ	문학에서, 직접 말하지 않고 다른 말로 바꾸어 암시적으로 나타내는 방법.
은자	ㅇㅡㄴㅈㅏ	세속을 떠나 숨어서 사는 사람.
은하	ㅇㅡㄴㅎㅏ	흰 구름 모양으로 길게 보이는 수많은 천체의 무리.
음가	ㅇㅡㅁㄱㅏ	낱낱의 글자가 가지고 있는 소리.
음기	ㅇㅡㅁㄱㅣ	어둡고 차가운 기운.
음료	ㅇㅡㅁㄹㅛ	물이나 물처럼 마시는 모든 액체.
음모	ㅇㅡㅁㅁㅗ	사람의 생식기 주위에 난 털.
음미	ㅇㅡㅁㅁㅣ	시가를 낮은 목소리로 읽거나 외면서 감상함.
음부	ㅇㅡㅁㅂㅜ	몸 밖으로 드러나 있는 남녀의 생식 기관.
음소	ㅇㅡㅁㅅㅗ	말의 뜻을 구별 짓는 소리의 최소 단위.
음수	ㅇㅡㅁㅅㅜ	0보다 작은 수.
음조	ㅇㅡㅁㅈㅗ	소리의 높낮이와 강약, 빠르기 등의 정도.
음주	ㅇㅡㅁㅈㅜ	술을 마심.
음지	ㅇㅡㅁㅈㅣ	햇빛이 잘 들지 않는 그늘진 곳.
음치	ㅇㅡㅁㅊㅣ	음을 제대로 분별하거나 소리 내지 못하는 사람.
음파	ㅇㅡㅁㅍㅏ	소리의 진동으로 생기는 파동.
음표	ㅇㅡㅁㅍㅛ	악보에서 음의 길이와 높낮이를 나타내는 기호.
읍소	ㅇㅡㅂㅅㅗ	눈물을 흘리며 억울한 일이나 어려운 상황 등을 간절히 말함.
응가	ㅇㅡㅇㄱㅏ	(어린아이의 말로) 똥. 또는 똥을 누는 일.
응고	ㅇㅡㅇㄱㅗ	액체가 한 덩어리로 뭉쳐 딱딱하게 굳어짐.
응모	ㅇㅡㅇㅁㅗ	모집에 응함.
응보	ㅇㅡㅇㅂㅗ	불교에서, 행동의 선악에 따라 나타나는 즐거움과 괴로움의 결과.
응수	ㅇㅡㅇㅅㅜ	상대의 말이나 행동에 대해 맞대어 응함.
응시	ㅇㅡㅇㅅㅣ	한 곳에 눈을 집중하여 똑바로 봄.
의거	ㅇㅡㅣㄱㅓ	어떤 사실이나 원리 등에 근거함.
의기	ㅇㅡㅣㄱㅣ	어떤 일을 하고자 하는 적극적이고 씩씩한 마음.
의도	ㅇㅡㅣㄷㅗ	무엇을 하고자 하는 생각이나 계획.
의료	ㅇㅡㅣㄹㅛ	의학과 관련된 기술로 상처나 병을 치료함. 또는 그런 일.
의류	ㅇㅡㅣㄹㅠ	티셔츠나 남방, 바지 등 모든 종류의 옷.
의리	ㅇㅡㅣㄹㅣ	사람으로서 지켜야 할 도리.
의무	ㅇㅡㅣㅁㅜ	마땅히 해야 할 일.
의미	ㅇㅡㅣㅁㅣ	말이나 글, 기호 등이 나타내는 뜻.
의사	ㅇㅡㅣㅅㅏ	무엇을 하고자 마음먹은 생각.
의아	ㅇㅡㅣㅇㅏ	의심스럽고 이상함.
의자	ㅇㅡㅣㅈㅏ	사람이 엉덩이와 허벅지를 대고 걸터앉는 데 쓰는 기구.
의지	ㅇㅡㅣㅈㅣ	다른 것에 몸을 기댐. 또는 그렇게 하는 대상.
의치	ㅇㅡㅣㅊㅣ	이가 빠진 자리에 만들어 박은 가짜 이.
이간	ㅇㅣㄱㅏㄴ	두 사람이나 나라의 사이에 끼어들어 오해를 일으키는 말을 하여 서로 멀어지게 함.
이감	ㅇㅣㄱㅏㅁ	한 교도소에 갇혀 있는 죄수를 다른 교도소로 옮김.
이견	ㅇㅣㄱㅕㄴ	어떠한 의견에 대한 다른 의견. 또는 서로 다른 의견.
이경	ㅇㅣㄱㅕㅇ	하룻밤을 다섯으로 나눈 오경의 둘째 부분으로, 밤 아홉 시부터 열한 시 사이.
이골	ㅇㅣㄱㅗㄹ	매우 익숙해져서 몸에 밴 행동이나 버릇.
이공	ㅇㅣㄱㅗㅇ	이학과 공학.
이과	ㅇㅣㄱㅗㅏ	생물, 물리, 화학, 천문 등 자연 과학을 연구하는 학과. 또는 그런 학문.
이국	ㅇㅣㄱㅜㄱ	문화나 풍속 등이 전혀 다른 남의 나라.
이끼	ㅇㅣㄱㄱㅣ	잎과 줄기의 구별이 뚜렷하지 않으며 그늘이 지고 습기가 많은 곳의 바위나 나무 등에서 자라는 식물.
이날	ㅇㅣㄴㅏㄹ	바로 앞에서 이야기한 날.
이남	ㅇㅣㄴㅏㅁ	기준이 되는 지점에서부터 그 남쪽.
이내	ㅇㅣㄴㅏㅣ	일정한 범위의 안.
이념	ㅇㅣㄴㅕㅁ	한 국가나 사회, 개인이 가지고 있는 생각의 근본이 되는, 이상적으로 여겨지는 사상.
이농	ㅇㅣㄴㅗㅇ	농민이 농사를 그만두고 농촌을 떠남. 또는 그런 현상.
이닝	ㅇㅣㄴㅣㅇ	야구에서, 양 팀이 공격과 수비를 한 번씩 끝내는 한 회.
이단	ㅇㅣㄷㅏㄴ	권위 있는 사상이나 학설 등에 반항하는 주장이나 이론.
이달	ㅇㅣㄷㅏㄹ	이번 달.
이담	ㅇㅣㄷㅏㅁ	이번의 바로 뒤에 이어져 오는 때나 차례.
이동	ㅇㅣㄷㅗㅇ	움직여서 옮김. 또는 움직여서 자리를 바꿈.
이득	ㅇㅣㄷㅡㄱ	이익을 얻음. 또는 그 이익.
이등	ㅇㅣㄷㅡㅇ	많은 것 가운데서 두 번째가 되는 등급.
이란	ㅇㅣㄹㅏㄴ	서남아시아에 있는 나라. 농업과 목축이 발달했으며, 주요 생산물로는 석유, 페르시아 융단 등이 있다. 주요 언어는 페르시아어이고 수도는 테헤란이다.
이랑	ㅇㅣㄹㅏㅇ	두 논이나 밭 사이의 경계를 이루는 작은 둑이나 언덕.
이레	ㅇㅣㄹㅓㅣ	일곱 날.
이력	ㅇㅣㄹㅕㄱ	한 사람이 지금까지 거쳐 온 학업, 직업, 경험 등의 경력.
이례	ㅇㅣㄹㅕㅣ	보통의 경우에서 벗어난 특이한 예.
이론	ㅇㅣㄹㅗㄴ	어떤 이치나 지식을 논리적으로 일반화한 명제의 체계.
이륙	ㅇㅣㄹㅠㄱ	비행기 등이 날기 위해 땅에서 떠오름.
이름	ㅇㅣㄹㅡㅁ	다른 것과 구별하기 위해 동물, 사물, 현상 등에 붙여서 부르는 말.
이면	ㅇㅣㅁㅕㄴ	물체의 뒤쪽 면.
이명	ㅇㅣㅁㅕㅇ	실제로는 아무 소리도 나지 않으나 귀에서 소리가 들리는 것처럼 느껴지는 병적인 상태.
이목	ㅇㅣㅁㅗㄱ	귀와 눈.
이문	ㅇㅣㅁㅜㄴ	이익으로 남은 돈.
이물	ㅇㅣㅁㅜㄹ	특이하고 이상한 물건.
이민	ㅇㅣㅁㅣㄴ	자기 나라를 떠나서 다른 나라로 가서 사는 것.
이발	ㅇㅣㅂㅏㄹ	머리털을 깎아 다듬음.
이방	ㅇㅣㅂㅏㅇ	문화나 풍속 등이 전혀 다른 남의 나라.
이번	ㅇㅣㅂㅓㄴ	곧 돌아올 차례. 또는 막 지나간 차례.
이변	ㅇㅣㅂㅕㄴ	미리 생각하지 못한 일이나 매우 이상한 일.
이별	ㅇㅣㅂㅕㄹ	오랫동안 만나지 못하게 떨어져 있거나 헤어짐.
이병	ㅇㅣㅂㅕㅇ	군대의 사병 중에서 제일 낮은 계급.
이복	ㅇㅣㅂㅗㄱ	아버지는 같고 어머니는 다름.
이본	ㅇㅣㅂㅗㄴ	주로 소설 등의 문학 작품에서 큰 줄거리는 같으나 부분적으로 내용이 다른 책.
이북	ㅇㅣㅂㅜㄱ	기준이 되는 지점에서부터 그 북쪽.
이불	ㅇㅣㅂㅜㄹ	잘 때 몸을 덮기 위하여 천 등으로 만든 것.
이삭	ㅇㅣㅅㅏㄱ	벼나 보리 등의 곡식에서, 꽃이 피고 열매가 열리는 부분.
이산	ㅇㅣㅅㅏㄴ	헤어지거나 이별하여 흩어짐.
이상	ㅇㅣㅅㅏㅇ	수량이나 정도가 일정한 기준을 포함하여 그보다 많거나 나은 것.
이새	ㅇㅣㅅㅏㅣ	이제까지의 꽤 짧은 동안.
이설	ㅇㅣㅅㅓㄹ	일반적으로 널리 알려진 것과는 다른 의견이나 주장.
이성	ㅇㅣㅅㅓㅇ	올바른 가치와 지식을 가지고 논리에 맞게 생각하고 판단하는 능력.
이세	ㅇㅣㅅㅓㅣ	다음 세대.
이송	ㅇㅣㅅㅗㅇ	다른 곳으로 옮겨 보냄.
이순	ㅇㅣㅅㅜㄴ	예순 살.
이슬	ㅇㅣㅅㅡㄹ	공기 중의 수증기가 기온이 내려가거나 찬 물체에 부딪혀서 한데 뭉치어 생긴 작은 물방울.
이승	ㅇㅣㅅㅡㅇ	지금 살고 있는 세상.
이식	ㅇㅣㅅㅣㄱ	나무 등을 다른 곳에 옮겨 심는 일.
이양	ㅇㅣㅇㅑㅇ	권리나 권력 등을 남에게 넘겨줌.
이온	ㅇㅣㅇㅗㄴ	양의 전기나 음의 전기를 띤 원자 또는 원자의 집단.
이외	ㅇㅣㅇㅗㅣ	어떤 범위의 밖.
이용	ㅇㅣㅇㅛㅇ	대상을 필요에 따라 이롭거나 쓸모가 있게 씀.
이웃	ㅇㅣㅇㅜㅅ	어떤 지역이나 나라에 나란히 또는 가까이 있음.
이윤	ㅇㅣㅇㅠㄴ	장사를 해서 번 돈.
이율	ㅇㅣㅇㅠㄹ	빌린 돈에 대한 이자의 비율.
이응	ㅇㅣㅇㅡㅇ	한글 자모 ‘ㅇ’의 이름.
이의	ㅇㅣㅇㅡㅣ	다른 의견이나 생각.
이익	ㅇㅣㅇㅣㄱ	물질적으로나 정신적으로 보탬이나 도움이 되는 것.
이임	ㅇㅣㅇㅣㅁ	맡아보던 일을 내놓고 자리를 떠남.
이입	ㅇㅣㅇㅣㅂ	옮기어 들여오거나 들어감.
이장	ㅇㅣㅈㅏㅇ	무덤을 옮김.
이적	ㅇㅣㅈㅓㄱ	기이한 행위의 흔적.
이전	ㅇㅣㅈㅓㄴ	지금보다 앞.
이점	ㅇㅣㅈㅓㅁ	이익이 되는 점.
이제	ㅇㅣㅈㅓㅣ	말하고 있는 바로 이때.
이종	ㅇㅣㅈㅗㅇ	이모의 아들이나 딸과의 친족 관계. 또는 그런 관계에 있는 사람.
이중	ㅇㅣㅈㅜㅇ	두 겹. 또는 두 번 겹치는 것.
이즘	ㅇㅣㅈㅡㅁ	얼마 전부터 지금까지의 시기.
이직	ㅇㅣㅈㅣㄱ	다니던 직장을 옮기거나 직업을 바꿈.
이질	ㅇㅣㅈㅣㄹ	성질이 다름. 또는 서로 다른 성질.
이참	ㅇㅣㅊㅏㅁ	곧 돌아올 차례. 또는 막 지나간 차례.
이체	ㅇㅣㅊㅓㅣ	은행 등 금융 기관의 계좌에 있는 돈을 은행 직원, 인터넷, 기계 등을 통하여 다른 계좌로 옮김.
이탈	ㅇㅣㅌㅏㄹ	어떤 범위나 줄, 기준 등에서 떨어져 나오거나 떨어져 나감.
이틀	ㅇㅣㅌㅡㄹ	두 날.
이해	ㅇㅣㅎㅏㅣ	이익과 손해.
이혼	ㅇㅣㅎㅗㄴ	결혼한 부부가 법적으로 부부 관계를 끊음.
익사	ㅇㅣㄱㅅㅏ	물에 빠져 죽음.
인가	ㅇㅣㄴㄱㅏ	사람이 사는 집.
인고	ㅇㅣㄴㄱㅗ	괴로움을 참음.
인구	ㅇㅣㄴㄱㅜ	정해진 지역에 살고 있는 사람의 수.
인기	ㅇㅣㄴㄱㅣ	어떤 대상에 쏠리는 많은 사람들의 높은 관심이나 좋아하는 마음.
인도	ㅇㅣㄴㄷㅗ	인종, 민족, 국가, 종교 등의 차이를 뛰어넘어 사람으로서 마땅히 지켜야 할 도리.
인두	ㅇㅣㄴㄷㅜ	바느질할 때 불에 달구어 구겨진 천을 눌러 펴거나 주름을 잡는 데 쓰던 기구.
인류	ㅇㅣㄴㄹㅠ	전 세계의 모든 사람.
인부	ㅇㅣㄴㅂㅜ	돈을 받고 육체노동을 하는 사람.
인사	ㅇㅣㄴㅅㅏ	사회적 지위가 높거나 사회에서 활발히 활동하는 사람.
인수	ㅇㅣㄴㅅㅜ	물건이나 권리, 일 등을 넘겨받음.
인어	ㅇㅣㄴㅇㅓ	몸의 위쪽은 사람의 모습과 같고 몸의 아래쪽은 물고기와 같다는 상상의 바다 동물.
인자	ㅇㅣㄴㅈㅏ	마음이 너그럽고 따뜻함. 또는 그 마음.
인조	ㅇㅣㄴㅈㅗ	사람이 만듦. 또는 그런 물건.
인주	ㅇㅣㄴㅈㅜ	도장을 찍을 때 묻혀서 쓰는 붉은 빛깔의 재료.
인지	ㅇㅣㄴㅈㅣ	엄지손가락과 가운뎃손가락의 사이에 있는 둘째 손가락.
인치	ㅇㅣㄴㅊㅣ	길이를 나타내는 단위.
인파	ㅇㅣㄴㅍㅏ	한곳에 몰려든 수많은 사람.
인하	ㅇㅣㄴㅎㅏ	물건값이나 월급, 요금 등을 내림.
인허	ㅇㅣㄴㅎㅓ	인정하여 허가함.
일가	ㅇㅣㄹㄱㅏ	한집에 사는 가족.
일기	ㅇㅣㄹㄱㅣ	한평생 살아 있는 동안.
일로	ㅇㅣㄹㄹㅗ	그렇게 되어 가는 경향.
일루	ㅇㅣㄹㄹㅜ	야구에서, 포수가 있는 본루와 이루 사이에 있는 첫째 누.
일류	ㅇㅣㄹㄹㅠ	어떤 방면에서 무엇보다 으뜸이 되는 지위나 부류.
일리	ㅇㅣㄹㄹㅣ	어떤 면에서 그런대로 옳다고 생각되는 이치.
일미	ㅇㅣㄹㅁㅣ	아주 뛰어나고 좋은 맛.
일보	ㅇㅣㄹㅂㅗ	(비유적으로) 한 걸음이라는 뜻으로, 아주 가까이 있음.
일부	ㅇㅣㄹㅂㅜ	한 부분. 또는 전체 중에서 얼마.
일소	ㅇㅣㄹㅅㅗ	한꺼번에 없앰.
일수	ㅇㅣㄹㅅㅜ	하루에 버는 돈.
일시	ㅇㅣㄹㅅㅣ	잠깐의 짧은 시간.
일어	ㅇㅣㄹㅇㅓ	일본인이 쓰는 말.
일자	ㅇㅣㄹㅈㅏ	날의 개수.
일조	ㅇㅣㄹㅈㅗ	얼마간의 도움을 줌. 또는 그 도움.
일주	ㅇㅣㄹㅈㅜ	일정한 길을 따라 한 바퀴 돎.
일지	ㅇㅣㄹㅈㅣ	매일매일 그날의 일을 적은 기록. 또는 그런 책.
일차	ㅇㅣㄹㅊㅏ	어떤 일에서 근본이 되거나 맨 처음이 되는 것.
일치	ㅇㅣㄹㅊㅣ	비교되는 대상이 서로 다르지 않고 꼭 같거나 들어맞음.
일터	ㅇㅣㄹㅌㅓ	일을 하는 곳.
임기	ㅇㅣㅁㄱㅣ	일을 맡아서 하는 일정한 기간.
임무	ㅇㅣㅁㅁㅜ	맡은 일. 또는 맡겨진 일.
임부	ㅇㅣㅁㅂㅜ	아이를 밴 여자.
임시	ㅇㅣㅁㅅㅣ	미리 정하지 않고 그때그때 필요에 따라 정한 것.
임야	ㅇㅣㅁㅇㅑ	숲과 들.
임자	ㅇㅣㅁㅈㅏ	물건을 소유한 사람.
임지	ㅇㅣㅁㅈㅣ	일을 맡아 근무하는 곳.
입가	ㅇㅣㅂㄱㅏ	입의 가장자리.
입고	ㅇㅣㅂㄱㅗ	창고에 물건을 넣음. 또는 새로운 상품이 들어옴.
입구	ㅇㅣㅂㄱㅜ	안으로 들어갈 수 있는 문이나 통로.
입사	ㅇㅣㅂㅅㅏ	회사 등에 일자리를 얻어 들어감.
입소	ㅇㅣㅂㅅㅗ	훈련소, 연구소, 교도소 등에 들어감.
입수	ㅇㅣㅂㅅㅜ	손에 들어옴. 또는 손에 넣음.
입시	ㅇㅣㅂㅅㅣ	입학하기 위해 치르는 시험.
입자	ㅇㅣㅂㅈㅏ	물질을 이루는 아주 작은 크기의 물체.
입주	ㅇㅣㅂㅈㅜ	원래 살던 곳을 떠나서 새로운 집이나 땅으로 옮겨 삶.
입지	ㅇㅣㅂㅈㅣ	식물이 자라는 일정한 장소의 환경.
입추	ㅇㅣㅂㅊㅜ	일 년 중 가을이 시작된다는 날로 이십사절기의 하나. 8월 8일경이다.
입하	ㅇㅣㅂㅎㅏ	일 년 중 여름이 시작된다는 날로 이십사절기의 하나. 5월 5일경이다.
잉어	ㅇㅣㅇㅇㅓ	주로 등은 검푸르고 배는 누르스름하며, 몸집이 크고 입 주변에 두 쌍의 수염이 있는 민물고기.
잉여	ㅇㅣㅇㅇㅕ	쓰고 난 후에 남은 것.
잉크	ㅇㅣㅇㅋㅡ	글씨를 쓰거나 인쇄하는 데 쓰는, 빛깔이 있는 액체.
자각	ㅈㅏㄱㅏㄱ	자기의 입장이나 능력 등을 스스로 느끼거나 깨달음.
자갈	ㅈㅏㄱㅏㄹ	강이나 바다의 바닥에서 물에 닳아 둥글고 매끄러워진 작은 돌.
자개	ㅈㅏㄱㅏㅣ	빛깔이 아름다워 여러 가지 장식으로 쓰는, 전복 등의 껍데기를 자른 조각.
자격	ㅈㅏㄱㅕㄱ	일정한 신분이나 지위.
자결	ㅈㅏㄱㅕㄹ	스스로 목숨을 끊음.
자국	ㅈㅏㄱㅜㄱ	다른 것이 닿거나 묻어서 생긴 자리. 또는 어떤 것 때문에 원래의 상태가 달라진 흔적.
자궁	ㅈㅏㄱㅜㅇ	아기가 태어나기 전까지 자리해서 자라는 여자의 몸속 기관.
자극	ㅈㅏㄱㅡㄱ	어떠한 작용을 주어 감각이나 마음에 반응을 일으키게 함. 또는 그런 사물.
자금	ㅈㅏㄱㅡㅁ	사업을 하는 데에 쓰는 돈.
자급	ㅈㅏㄱㅡㅂ	자기에게 필요한 것을 스스로 마련하여 채움.
자긍	ㅈㅏㄱㅡㅇ	스스로를 자랑스러워하는 마음을 가짐.
자당	ㅈㅏㄷㅏㅇ	(높이는 말로) 남의 어머니.
자동	ㅈㅏㄷㅗㅇ	기계 등이 일정한 장치에 의해 스스로 작동함.
자락	ㅈㅏㄹㅏㄱ	옷이나 천의 아래로 늘어진 부분.
자랑	ㅈㅏㄹㅏㅇ	자기 또는 자기와 관계있는 사람이나 물건이 남에게 칭찬을 받을 만한 것임을 드러내어 말하거나 뽐냄.
자력	ㅈㅏㄹㅕㄱ	스스로의 힘.
자립	ㅈㅏㄹㅣㅂ	남에게 매이거나 의지하지 않고 자기 힘으로 살아감.
자막	ㅈㅏㅁㅏㄱ	영화나 텔레비전 등에서, 관객이나 시청자가 읽을 수 있도록 제목, 대화, 설명 등을 화면에 나타내는 글자.
자만	ㅈㅏㅁㅏㄴ	자기에 관한 것을 스스로 자랑하며 잘난 체함.
자매	ㅈㅏㅁㅏㅣ	언니와 여동생 사이.
자멸	ㅈㅏㅁㅕㄹ	스스로의 실수나 잘못으로 자신을 망치거나 멸망함.
자몽	ㅈㅏㅁㅗㅇ	귤과 비슷한데, 신맛이 강하고 새콤한 향기가 나며 살이 부드럽고 즙이 많은 열매.
자문	ㅈㅏㅁㅜㄴ	자기 자신에게 물음.
자반	ㅈㅏㅂㅏㄴ	고등어나 굴비 등의 생선을 소금에 절인 것. 또는 그것을 굽거나 쪄서 만든 반찬.
자본	ㅈㅏㅂㅗㄴ	장사나 사업 등을 하는 데에 바탕이 되는 돈.
자산	ㅈㅏㅅㅏㄴ	개인이나 법인이 가지고 있는, 경제적 가치가 있는 재산.
자살	ㅈㅏㅅㅏㄹ	스스로 자신의 목숨을 끊음.
자상	ㅈㅏㅅㅏㅇ	날카로운 것에 찔려서 난 상처.
자석	ㅈㅏㅅㅓㄱ	쇠붙이를 끌어당기는 힘을 띤 물체.
자선	ㅈㅏㅅㅓㄴ	형편이 어려운 사람을 불쌍히 여겨 도와줌.
자성	ㅈㅏㅅㅓㅇ	자신의 태도나 행동을 반성함.
자세	ㅈㅏㅅㅓㅣ	몸을 움직이거나 가누는 태도.
자손	ㅈㅏㅅㅗㄴ	자식과 손자.
자숙	ㅈㅏㅅㅜㄱ	자신의 행동을 스스로 조심함.
자습	ㅈㅏㅅㅡㅂ	혼자 힘으로 공부함.
자식	ㅈㅏㅅㅣㄱ	아들과 딸, 또는 아들이나 딸.
자신	ㅈㅏㅅㅣㄴ	바로 그 사람.
자애	ㅈㅏㅇㅏㅣ	아랫사람에게 베푸는 따뜻하고 깊은 사랑.
자연	ㅈㅏㅇㅕㄴ	사람의 힘에 의한 것이 아닌, 세상에 원래부터 있거나 저절로 이루어지는 모든 현상이나 존재.
자영	ㅈㅏㅇㅕㅇ	사업 등을 자신이 직접 관리하고 운영함.
자위	ㅈㅏㅇㅜㅣ	자기 마음을 스스로 위로하거나 달램.
자율	ㅈㅏㅇㅠㄹ	남의 지배나 구속을 받지 않고 스스로의 원칙에 따라 자신의 행위를 통제하는 일.
자음	ㅈㅏㅇㅡㅁ	목, 입, 혀 등의 발음 기관에 의해 장애를 받으며 나는 소리.
자의	ㅈㅏㅇㅡㅣ	자기 생각이나 뜻.
자인	ㅈㅏㅇㅣㄴ	스스로 인정함.
자작	ㅈㅏㅈㅏㄱ	제 손으로 직접 만들거나 지음. 또는 그렇게 만든 것.
자재	ㅈㅏㅈㅏㅣ	어떤 것을 만들 때 필요한 기본적인 물건이나 재료.
자전	ㅈㅏㅈㅓㄴ	자신이 일생 동안 하거나 겪은 일 등을 스스로 적은 기록.
자정	ㅈㅏㅈㅓㅇ	밤 열두 시.
자제	ㅈㅏㅈㅓㅣ	다른 사람을 높여 그의 아들을 이르는 말.
자족	ㅈㅏㅈㅗㄱ	스스로 넉넉함을 느껴 만족함.
자존	ㅈㅏㅈㅗㄴ	자기의 존재.
자진	ㅈㅏㅈㅣㄴ	스스로 나섬.
자질	ㅈㅏㅈㅣㄹ	타고난 성격이나 소질.
자찬	ㅈㅏㅊㅏㄴ	스스로 자기를 칭찬함.
자청	ㅈㅏㅊㅓㅇ	스스로 어떤 일을 하겠다고 나섬.
자체	ㅈㅏㅊㅓㅣ	다른 것이 아닌 바로 그것.
자축	ㅈㅏㅊㅜㄱ	자기에게 생긴 좋은 일을 스스로 축하함.
자취	ㅈㅏㅊㅜㅣ	어떤 것이 남긴 표시나 흔적.
자칭	ㅈㅏㅊㅣㅇ	자기 자신이나 자기가 한 일을 스스로 칭찬함.
자탄	ㅈㅏㅌㅏㄴ	자기의 일에 스스로 탄식함.
자태	ㅈㅏㅌㅏㅣ	여성의 아름다운 모습이나 태도.
자퇴	ㅈㅏㅌㅗㅣ	다니던 학교를 스스로 그만둠.
자판	ㅈㅏㅍㅏㄴ	컴퓨터에서, 문자나 기호를 입력하는 글자판.
자폐	ㅈㅏㅍㅕㅣ	주위에 관심을 두지 않고 다른 사람과 관계를 맺지 못하며 자기의 내면 속으로만 빠져드는  병.
자폭	ㅈㅏㅍㅗㄱ	자기가 지닌 폭발물을 스스로 폭발시킴.
자필	ㅈㅏㅍㅣㄹ	자기 손으로 직접 글씨를 씀. 또는 그 글씨.
자학	ㅈㅏㅎㅏㄱ	스스로 자기 자신을 몹시 괴롭게 함.
자해	ㅈㅏㅎㅏㅣ	스스로 자신의 몸을 다치게 함.
자형	ㅈㅏㅎㅕㅇ	누나의 남편을 이르거나 부르는 말.
작가	ㅈㅏㄱㄱㅏ	시, 소설, 연극, 방송 대본, 그림 등을 처음으로 만들어 내는 사람.
작고	ㅈㅏㄱㄱㅗ	(높이는 말로) 사람의 죽음.
작두	ㅈㅏㄱㄷㅜ	나무토막 위에 긴 칼날을 달고 그 사이에 짚, 풀, 약재 등을 넣어 써는 연장.
작부	ㅈㅏㄱㅂㅜ	술집에서 손님에게 술을 따라 주고 시중을 드는 여자.
작사	ㅈㅏㄱㅅㅏ	노랫말을 지음.
작자	ㅈㅏㄱㅈㅏ	글이나 곡을 지은 사람.
작파	ㅈㅏㄱㅍㅏ	어떤 계획이나 일을 중간에 그만둠.
잔고	ㅈㅏㄴㄱㅗ	남은 돈의 액수.
잔디	ㅈㅏㄴㄷㅣ	정원, 공원, 골프장 등에 심는 잎이 짧고 가늘며, 촘촘하게 자라는 풀.
잔류	ㅈㅏㄴㄹㅠ	뒤에 처져 남아 있음.
잔여	ㅈㅏㄴㅇㅕ	아직 남아 있음. 또는 그런 나머지.
잔치	ㅈㅏㄴㅊㅣ	기쁜 일이 있을 때에 음식을 차려 놓고 여러 사람이 모여 즐기는 일.
잠기	ㅈㅏㅁㄱㅣ	잠이 오거나 잠에서 깨어나지 못한 기운.
잠바	ㅈㅏㅁㅂㅏ	품이 넉넉해 웃옷 위에 덧입기 좋고 활동하기에도 편한 겉옷.
잠보	ㅈㅏㅁㅂㅗ	잠을 많이 자는 사람.
잠수	ㅈㅏㅁㅅㅜ	물속에 몸 전체가 잠기도록 들어감.
잠시	ㅈㅏㅁㅅㅣ	잠깐 동안.
잡기	ㅈㅏㅂㄱㅣ	잡스럽고 다양한 놀이의 기술이나 재주.
잡무	ㅈㅏㅂㅁㅜ	여러 가지 자질구레한 사무나 일.
잡부	ㅈㅏㅂㅂㅜ	주로 공사장에서 여러 가지 자질구레한 일을 하는 사람.
잡비	ㅈㅏㅂㅂㅣ	여러 가지 자질구레한 데 쓰는 돈.
잡지	ㅈㅏㅂㅈㅣ	여러 가지 내용의 기사와 사진, 광고 등을 모아 정기적으로 발행하는 책.
잡초	ㅈㅏㅂㅊㅗ	가꾸지 않아도 저절로 나서 자라는 여러 가지 풀.
잡티	ㅈㅏㅂㅌㅣ	여러 가지 자질구레한 티나 흠.
장가	ㅈㅏㅇㄱㅏ	남자가 아내를 맞는 일.
장고	ㅈㅏㅇㄱㅗ	오랫동안 깊이 생각함.
장교	ㅈㅏㅇㄱㅛ	육군, 해군, 공군의 소위 이상의 군인.
장구	ㅈㅏㅇㄱㅜ	가운데가 잘록한 나무통 모양으로, 양쪽 끝의 가죽을 손이나 채로 두드려 소리를 내는, 한국 전통 음악에서 쓰는 악기.
장기	ㅈㅏㅇㄱㅣ	가장 잘하는 재주.
장녀	ㅈㅏㅇㄴㅕ	여러 명의 딸 가운데 가장 먼저 태어난 딸.
장도	ㅈㅏㅇㄷㅗ	중요한 임무나 큰 뜻을 품고 떠나는 길.
장려	ㅈㅏㅇㄹㅕ	좋은 일을 하도록 권하거나 북돋아 줌.
장로	ㅈㅏㅇㄹㅗ	나이가 많고 지식과 덕을 많이 쌓은 사람.
장르	ㅈㅏㅇㄹㅡ	문학이나 예술의 갈래나 분야.
장마	ㅈㅏㅇㅁㅏ	여름철에 여러 날 계속해서 비가 오는 현상이나 날씨. 또는 그 비.
장모	ㅈㅏㅇㅁㅗ	아내의 어머니.
장미	ㅈㅏㅇㅁㅣ	줄기에 가시가 있고 오월이나 유월에 향기롭게 피는 빨간색, 하얀색, 노란색 등의 꽃.
장부	ㅈㅏㅇㅂㅜ	다 자란 씩씩한 남자.
장비	ㅈㅏㅇㅂㅣ	어떤 일을 하기 위하여 갖추어야 할 물건이나 시설. 또는 그 물건이나 시설을 갖춤.
장사	ㅈㅏㅇㅅㅏ	이익을 얻으려고 물건을 사서 팖. 또는 그런 일.
장서	ㅈㅏㅇㅅㅓ	책을 잘 보관해 둠. 또는 그 책.
장소	ㅈㅏㅇㅅㅗ	어떤 일이 일어나는 곳. 또는 어떤 일을 하는 곳.
장수	ㅈㅏㅇㅅㅜ	물건을 사람들에게 파는 사람.
장어	ㅈㅏㅇㅇㅓ	몸이 가늘고 길며 약간 탁하고 어두운 노란색이나 검은색을 띠는, 뱀과 비슷하게 생긴 민물고기.
장자	ㅈㅏㅇㅈㅏ	둘 이상의 아들 가운데 첫째로 태어난 아들.
장조	ㅈㅏㅇㅈㅗ	장음계로 된 곡조.
장지	ㅈㅏㅇㅈㅣ	다섯 손가락 중 한 가운데 있는 가장 긴 손가락.
장치	ㅈㅏㅇㅊㅣ	어떤 목적에 따라 일을 해낼 수 있도록 기계나 도구 등을 설치함. 또는 그 기계나 도구.
장터	ㅈㅏㅇㅌㅓ	많은 사람들이 모여 물건을 사고파는 장이 서는 곳.
재가	ㅈㅏㅣㄱㅏ	결혼했던 여자가 남편과 사별하거나 이혼한 후 다른 남자와 다시 결혼함.
재고	ㅈㅏㅣㄱㅗ	어떤 일이나 문제 등에 대하여 다시 생각함.
재기	ㅈㅏㅣㄱㅣ	재주가 있는 성질이나 특징.
재료	ㅈㅏㅣㄹㅛ	물건을 만드는 데 쓰이는 것.
재무	ㅈㅏㅣㅁㅜ	돈이나 재산에 관한 일.
재미	ㅈㅏㅣㅁㅣ	어떤 것이 주는 즐거운 기분이나 느낌.
재수	ㅈㅏㅣㅅㅜ	입학시험에 떨어지고 나서 다음에 있을 입학시험을 보기 위해 다시 공부함.
재야	ㅈㅏㅣㅇㅑ	정부 기관에 속하지 않고 일반 국민들 사이에 있음.
재주	ㅈㅏㅣㅈㅜ	무엇을 잘하는 타고난 능력.
재즈	ㅈㅏㅣㅈㅡ	미국 흑인들의 민속 음악을 바탕으로 만들어진 대중음악.
재차	ㅈㅏㅣㅊㅏ	두 번째.
재치	ㅈㅏㅣㅊㅣ	어떤 일을 눈치 빠르고 능숙하게 처리하는 재주.
저격	ㅈㅓㄱㅕㄱ	어떤 대상을 겨냥하여 총을 쏨.
저공	ㅈㅓㄱㅗㅇ	땅이나 물의 겉면에서 가까운 낮은 하늘.
저금	ㅈㅓㄱㅡㅁ	돈을 모아 두거나 은행 등의 금융 기관에 맡김. 또는 그런 돈.
저급	ㅈㅓㄱㅡㅂ	품질이나 수준 등이 낮음.
저녁	ㅈㅓㄴㅕㄱ	해가 지기 시작할 때부터 밤이 될 때까지의 동안.
저당	ㅈㅓㄷㅏㅇ	맞서서 겨룸.
저력	ㅈㅓㄹㅕㄱ	겉으로 보이지 않지만 어려울 때 드러나는 든든한 힘.
저명	ㅈㅓㅁㅕㅇ	세상에 이름이 널리 알려져 있음.
저번	ㅈㅓㅂㅓㄴ	말하고 있는 때 이전의 지나간 차례나 때.
저변	ㅈㅓㅂㅕㄴ	어떤 것의 아래가 되는 부분.
저속	ㅈㅓㅅㅗㄱ	고상하지 못하고 천함.
저술	ㅈㅓㅅㅜㄹ	주로 학술적인 글이나 책 등을 씀. 또는 그런 글이나 책.
저승	ㅈㅓㅅㅡㅇ	사람이 죽으면 그 영혼이 가서 산다는 세상.
저온	ㅈㅓㅇㅗㄴ	낮은 온도.
저울	ㅈㅓㅇㅜㄹ	물건의 무게를 다는 데 쓰는 기구.
저음	ㅈㅓㅇㅡㅁ	낮은 소리.
저의	ㅈㅓㅇㅡㅣ	겉으로 드러나지 않은, 속에 품고 있는 생각.
저작	ㅈㅓㅈㅏㄱ	어떤 분야에 관한 책이나 작품 등을 지음. 또는 그 책이나 작품.
저장	ㅈㅓㅈㅏㅇ	물건이나 재화 등을 모아서 보관함.
저질	ㅈㅓㅈㅣㄹ	낮고 좋지 못한 품질.
저촉	ㅈㅓㅊㅗㄱ	법이나 규칙 등에 위반되거나 어긋남.
저축	ㅈㅓㅊㅜㄱ	돈이나 재물 등을 아껴 써서 모아 둠.
저층	ㅈㅓㅊㅡㅇ	여러 층으로 된 것의 아래쪽에 있는 층.
저항	ㅈㅓㅎㅏㅇ	어떤 힘이나 조건에 굽히지 않고 거역하거나 견딤.
저해	ㅈㅓㅎㅏㅣ	막아서 못하도록 해를 끼침.
적기	ㅈㅓㄱㄱㅣ	적의 깃발.
적도	ㅈㅓㄱㄷㅗ	지구의 중심을 지나는 자전축에 수직인 평면과 지표가 교차되는 선.
적소	ㅈㅓㄱㅅㅗ	꼭 알맞은 자리.
적수	ㅈㅓㄱㅅㅜ	재주나 힘이 서로 비슷해서 맞서 겨룰 만한 상대.
적시	ㅈㅓㄱㅅㅣ	알맞은 때.
적요	ㅈㅓㄱㅇㅛ	쓸쓸하고 고요함.
적자	ㅈㅓㄱㅈㅏ	나간 돈이 들어온 돈보다 많아서 생기는 손실 금액.
적지	ㅈㅓㄱㅈㅣ	적이 빼앗았거나 차지하고 있는 땅.
전가	ㅈㅓㄴㄱㅏ	부모가 자식에게 집안 살림을 물려줌.
전교	ㅈㅓㄴㄱㅛ	한 학교의 전체.
전구	ㅈㅓㄴㄱㅜ	전기를 통하여 빛을 내는 유리로 된 둥근 기구.
전기	ㅈㅓㄴㄱㅣ	어떤 글의 앞부분에 씀. 또는 그런 기록.
전도	ㅈㅓㄴㄷㅗ	전체를 그린 그림이나 지도.
전류	ㅈㅓㄴㄹㅠ	전기가 흐르는 현상이나 그 정도.
전모	ㅈㅓㄴㅁㅗ	사건이나 사물 등의 전체의 내용이나 모습.
전무	ㅈㅓㄴㅁㅜ	전혀 없음.
전보	ㅈㅓㄴㅂㅗ	문자나 숫자를 전기 신호로 바꿔서 전파나 전류로 짧은 시간 안에 보내는 통신이나 통보.
전부	ㅈㅓㄴㅂㅜ	각 부분을 모두 합친 전체.
전사	ㅈㅓㄴㅅㅏ	전쟁터에서 싸우다 죽음.
전서	ㅈㅓㄴㅅㅓ	한 사람이 쓴 책을 모두 모아 하나로 묶은 책.
전소	ㅈㅓㄴㅅㅗ	남김없이 다 타 버림.
전수	ㅈㅓㄴㅅㅜ	기술이나 지식 등을 전해 줌.
전시	ㅈㅓㄴㅅㅣ	찾아온 사람들에게 보여 주도록 여러 가지 물품을 한곳에 차려 놓음.
전야	ㅈㅓㄴㅇㅑ	어제의 밤.
전우	ㅈㅓㄴㅇㅜ	전쟁터에서 함께 싸운 동료.
전이	ㅈㅓㄴㅇㅣ	자리나 위치 등을 다른 곳으로 옮김.
전자	ㅈㅓㄴㅈㅏ	말하고 있는 때 이전의 지나간 차례나 때.
전조	ㅈㅓㄴㅈㅗ	어떤 일이 일어날 것 같은 분위기나 느낌.
전주	ㅈㅓㄴㅈㅜ	한국의 전라북도 중앙부에 있는 시. 전라북도의 도청 소재지이며, 창호지, 장판지의 생산과 전주비빔밥 등으로 유명하다.
전차	ㅈㅓㄴㅊㅏ	공중에 설치한 전선으로부터 전력을 공급받아 땅 위에 놓인 선로를 다니는 차.
전처	ㅈㅓㄴㅊㅓ	이혼이나 재혼을 하였을 때, 전에 결혼했던 아내.
전치	ㅈㅓㄴㅊㅣ	병을 완전히 고침.
전투	ㅈㅓㄴㅌㅜ	두 편의 군대가 무기를 갖추고 서로 싸움.
전파	ㅈㅓㄴㅍㅏ	전하여 널리 퍼지게 함.
전표	ㅈㅓㄴㅍㅛ	은행, 회사, 상점 등에서 돈이나 물건의 거래 내용을 간단히 적은 쪽지.
전하	ㅈㅓㄴㅎㅏ	(높이는 말로) 조선 시대에, 왕을 이르거나 부르는 말.
전후	ㅈㅓㄴㅎㅜ	앞과 뒤.
절교	ㅈㅓㄹㄱㅛ	서로 사귀어 가깝게 지내던 관계를 끊음.
절구	ㅈㅓㄹㄱㅜ	곡식을 빻거나 찧는 기구.
절규	ㅈㅓㄹㄱㅠ	있는 힘을 다해 매우 간절하고 애타게 부르짖음.
절기	ㅈㅓㄹㄱㅣ	일 년을 스물넷으로 나눈 계절의 구분.
절도	ㅈㅓㄹㄷㅗ	말이나 행동이 질서가 있고 정도에 알맞은 것.
절주	ㅈㅓㄹㅈㅜ	술 마시는 양을 알맞게 줄임.
절차	ㅈㅓㄹㅊㅏ	일을 해 나갈 때 거쳐야 하는 순서나 방법.
절하	ㅈㅓㄹㅎㅏ	화폐 가치의 수준을 낮춤.
절호	ㅈㅓㄹㅎㅗ	무엇을 하기에 기회나 시기 등이 아주 좋음.
점거	ㅈㅓㅁㄱㅓ	어떤 장소를 차지하여 자리를 잡음.
점수	ㅈㅓㅁㅅㅜ	성적을 나타내는 숫자.
점유	ㅈㅓㅁㅇㅠ	물건이나 영역, 지위 등을 차지함.
점자	ㅈㅓㅁㅈㅏ	손가락으로 더듬어 읽도록 만든 시각 장애인용 문자.
점주	ㅈㅓㅁㅈㅜ	가게의 주인.
점지	ㅈㅓㅁㅈㅣ	신이 사람에게 자식을 갖게 해 줌.
점차	ㅈㅓㅁㅊㅏ	차례를 따라 나아감.
점퍼	ㅈㅓㅁㅍㅓ	놀이나 운동하기에 적당한 활동적인 웃옷.
점포	ㅈㅓㅁㅍㅗ	물건을 파는 곳.
점프	ㅈㅓㅁㅍㅡ	뛰어올라 높은 곳으로 오름.
점호	ㅈㅓㅁㅎㅗ	한 사람씩 이름을 불러 인원이 맞는가를 알아봄.
접사	ㅈㅓㅂㅅㅏ	혼자 쓰이지 않고 어근이나 단어에 붙어 새로운 단어를 만드는 부분.
접수	ㅈㅓㅂㅅㅜ	권력으로써 다른 사람의 물건을 일방적으로 거두어들여 사용함.
접시	ㅈㅓㅂㅅㅣ	음식을 담는 데 쓰는 납작하고 평평한 그릇.
정가	ㅈㅓㅇㄱㅏ	상품에 일정한 값을 매김. 또는 그 값.
정규	ㅈㅓㅇㄱㅠ	정식으로 정해진 규칙이나 규범.
정기	ㅈㅓㅇㄱㅣ	기한이나 기간이 일정하게 정해져 있음. 또는 그 기한이나 기간.
정도	ㅈㅓㅇㄷㅗ	사람이 따라야 할 올바른 길이나 정당한 도리.
정리	ㅈㅓㅇㄹㅣ	흐트러지거나 어수선한 상태에 있는 것을 한데 모으거나 치움.
정모	ㅈㅓㅇㅁㅗ	의식 때 입는 옷이나 제복에 갖추어 쓰는 모자.
정무	ㅈㅓㅇㅁㅜ	정치나 국가 행정과 관계되는 사무.
정미	ㅈㅓㅇㅁㅣ	기계로 벼를 찧어 쌀을 만듦.
정보	ㅈㅓㅇㅂㅗ	어떤 사실이나 현상을 관찰하거나 측정하여 모은 자료를 정리한 지식. 또는 그 자료.
정부	ㅈㅓㅇㅂㅜ	입법, 사법, 행정의 삼권을 포함하는 통치 기구.
정비	ㅈㅓㅇㅂㅣ	흐트러진 체계를 정리하여 제대로 갖춤.
정사	ㅈㅓㅇㅅㅏ	정통적인 역사 체계에 따라 쓰인 정확한 사실의 역사. 또는 그런 기록.
정서	ㅈㅓㅇㅅㅓ	기쁨, 슬픔, 사랑, 미움 등과 같이 사람의 마음에 일어나는 여러 가지 감정.
정수	ㅈㅓㅇㅅㅜ	물을 깨끗하고 맑게 함. 또는 그 물.
정시	ㅈㅓㅇㅅㅣ	정해진 때나 시간.
정오	ㅈㅓㅇㅇㅗ	낮 열두 시.
정유	ㅈㅓㅇㅇㅠ	식물의 꽃, 잎, 열매, 줄기, 뿌리 등에서 얻은 향기로운 휘발성 기름.
정자	ㅈㅓㅇㅈㅏ	놀거나 쉬기 위해 경치가 좋은 곳에 지은, 벽이 없이 기둥과 지붕만 있는 집.
정조	ㅈㅓㅇㅈㅗ	여자의 곧은 절개.
정지	ㅈㅓㅇㅈㅣ	움직이고 있던 것이 멈춤. 또는 멈추게 함.
정차	ㅈㅓㅇㅊㅏ	차가 잠시 멈춤. 또는 차를 잠시 멈추게 함.
정처	ㅈㅓㅇㅊㅓ	정해진 곳. 또는 일정한 장소.
정초	ㅈㅓㅇㅊㅗ	그해의 맨 처음. 또는 음력 첫째 달의 처음 며칠.
정치	ㅈㅓㅇㅊㅣ	사회 질서를 바로잡고 국민의 기본 생활을 보장하기 위해 국가의 권력을 유지하며 나라를 다스리는 일.
정파	ㅈㅓㅇㅍㅏ	이해관계에 따라 따로 갈라진 정치인의 집단.
정표	ㅈㅓㅇㅍㅛ	정성스러운 정을 나타내기 위해 물건을 줌. 또는 그 물건.
젖니	ㅈㅓㅈㄴㅣ	어릴 때 나서 갈기 전까지 사용하는 이.
젖소	ㅈㅓㅈㅅㅗ	젖을 짜기 위하여 기르는 소.
제거	ㅈㅓㅣㄱㅓ	없애 버림.
제고	ㅈㅓㅣㄱㅗ	정도를 높임.
제구	ㅈㅓㅣㄱㅜ	야구에서, 투수가 원하는 대로 공을 던지는 일.
제기	ㅈㅓㅣㄱㅣ	아이들이 발로 차며 노는 한국의 전통적인 장난감.
제도	ㅈㅓㅣㄷㅗ	관습, 도덕, 법률 등의 규범이나 사회 구조의 체계.
제로	ㅈㅓㅣㄹㅗ	값이 없는 수.
제모	ㅈㅓㅣㅁㅗ	몸에 있는 털을 뽑거나 깎아서 없앰.
제보	ㅈㅓㅣㅂㅗ	정보를 제공함.
제부	ㅈㅓㅣㅂㅜ	언니가 여동생의 남편을 이르거나 부르는 말.
제비	ㅈㅓㅣㅂㅣ	등은 검고 배는 희며 매우 빠르게 날고, 봄에 한국에 날아왔다가 가을에 남쪽으로 날아가는 작은 여름 철새.
제사	ㅈㅓㅣㅅㅏ	신이나 죽은 사람의 영혼에게 음식을 바쳐 정성을 나타냄. 또는 그런 의식.
제소	ㅈㅓㅣㅅㅗ	소송을 일으킴.
제수	ㅈㅓㅣㅅㅜ	남자의 입장에서 남동생의 아내.
제시	ㅈㅓㅣㅅㅣ	무엇을 하고자 하는 생각을 말이나 글로 나타내어 보임.
제야	ㅈㅓㅣㅇㅑ	한 해의 마지막 날 밤.
제어	ㅈㅓㅣㅇㅓ	상대를 눌러 자기 마음대로 함.
제자	ㅈㅓㅣㅈㅏ	스승으로부터 가르침을 받았거나 받고 있는 사람.
제조	ㅈㅓㅣㅈㅗ	원료를 가공하여 물건을 만듦.
제지	ㅈㅓㅣㅈㅣ	말려서 못 하게 함.
제초	ㅈㅓㅣㅊㅗ	잡초를 뽑아 없앰.
제하	ㅈㅓㅣㅎㅏ	제목 아래.
제후	ㅈㅓㅣㅎㅜ	봉건 시대에 왕으로부터 일정한 영토를 받아 그 안에 사는 백성을 다스리던 사람.
제휴	ㅈㅓㅣㅎㅠ	원하는 일을 함께 이루기 위해 서로 도와줌.
조각	ㅈㅗㄱㅏㄱ	한 물건에서 따로 떼어 내거나 떨어져 나온 작은 부분.
조간	ㅈㅗㄱㅏㄴ	매일 아침에 발행하는 신문.
조개	ㅈㅗㄱㅏㅣ	바닷물이나 민물에서 사는, 단단하고 둥글고 납작한 두 쪽의 껍질 속에 사람이 먹을 수 있는 살이 들어 있는 동물.
조건	ㅈㅗㄱㅓㄴ	어떤 일을 이루게 하기 위하여 미리 갖추어야 할 상태나 요소.
조경	ㅈㅗㄱㅕㅇ	경치를 아름답게 꾸밈.
조국	ㅈㅗㄱㅜㄱ	조상 때부터 대대로 살던 나라.
조금	ㅈㅗㄱㅡㅁ	적은 분량이나 적은 정도.
조깅	ㅈㅗㄱㅣㅇ	건강을 유지하기 위하여 천천히 달리는 운동.
조끼	ㅈㅗㄱㄱㅣ	윗옷에 덧입는, 소매가 없는 옷.
조난	ㅈㅗㄴㅏㄴ	항해나 등산 중에 재난을 만남.
조달	ㅈㅗㄷㅏㄹ	필요한 돈이나 물건 등을 대어 줌.
조락	ㅈㅗㄹㅏㄱ	풀잎이나 나뭇잎 등이 시들어 떨어짐.
조력	ㅈㅗㄹㅕㄱ	힘을 써 도와줌. 또는 그 힘.
조련	ㅈㅗㄹㅕㄴ	군인으로서 전투에 필요한 것을 훈련함.
조례	ㅈㅗㄹㅕㅣ	지방 자치 단체가 그 지방의 사무와 관련하여 지방 의회의 회의를 거쳐 정한 법.
조롱	ㅈㅗㄹㅗㅇ	어떤 대상을 얕잡아 보고 비웃거나 놀림.
조림	ㅈㅗㄹㅣㅁ	고기, 생선, 채소 등을 양념해서 국물이 거의 남지 않게 바짝 끓여 만든 음식.
조립	ㅈㅗㄹㅣㅂ	여러 부품을 일정한 방식으로 짜 맞추어 하나의 물건으로 만듦. 또는 그런 것.
조막	ㅈㅗㅁㅏㄱ	(비유적으로) 주먹보다 작은 크기의 덩이.
조망	ㅈㅗㅁㅏㅇ	먼 곳을 바라봄. 또는 먼 곳의 경치.
조명	ㅈㅗㅁㅕㅇ	빛을 비추어 밝게 보이게 함.
조목	ㅈㅗㅁㅗㄱ	법률이나 규정 등의 각각의 부분.
조문	ㅈㅗㅁㅜㄴ	죽은 사람이 살아 있을 때 한 좋은 일이나 업적을 칭찬하고, 죽은 뒤에도 복을 받기를 비는 글.
조반	ㅈㅗㅂㅏㄴ	아침에 먹는 밥.
조산	ㅈㅗㅅㅏㄴ	아이를 낳을 달이 되기 전에 아이를 낳음.
조상	ㅈㅗㅅㅏㅇ	한 집안에서 먼저 태어나 살다가 돌아가신 어른.
조석	ㅈㅗㅅㅓㄱ	아침과 저녁.
조선	ㅈㅗㅅㅓㄴ	한반도에 있던 나라. 1392년 이성계가 고려를 멸망시키고 한양을 수도로 하여 세웠으며 성리학을 주요 이념으로 하였다. 1910년 일본에 국권을 빼앗기고 멸망하였다.
조성	ㅈㅗㅅㅓㅇ	무엇을 만들어서 이룸.
조세	ㅈㅗㅅㅓㅣ	국가나 지방 공공 단체가 필요한 경비로 사용하기 위해 국민으로부터 강제로 거두어들이는 돈.
조손	ㅈㅗㅅㅗㄴ	조부모와 손주.
조숙	ㅈㅗㅅㅜㄱ	식물의 열매가 일찍 익음.
조식	ㅈㅗㅅㅣㄱ	아침에 먹는 밥.
조신	ㅈㅗㅅㅣㄴ	행동이나 태도를 조심함.
조심	ㅈㅗㅅㅣㅁ	좋지 않은 일을 겪지 않도록 말이나 행동 등에 주의를 함.
조약	ㅈㅗㅇㅑㄱ	세부적인 항목을 세워 맺은 약속.
조언	ㅈㅗㅇㅓㄴ	도움이 되도록 말로 거들거나 깨우쳐 줌. 또는 그런 말.
조업	ㅈㅗㅇㅓㅂ	기계 등을 움직여서 일을 함.
조역	ㅈㅗㅇㅕㄱ	남의 일을 함께 하면서 도와줌. 또는 그런 일.
조연	ㅈㅗㅇㅕㄴ	연극이나 영화에서 주인공을 도와 이야기를 전개해 나가는 역할을 함. 또는 그런 역할을 맡은 배우.
조예	ㅈㅗㅇㅕㅣ	학문이나 예술, 기술 등의 분야에 대해 가지고 있는 많은 경험이나 깊은 지식.
조율	ㅈㅗㅇㅠㄹ	악기의 소리를 기준이 되는 음에 맞게 조정함.
조응	ㅈㅗㅇㅡㅇ	둘 이상의 사물이나 현상, 말과 글의 앞뒤 등이 서로 알맞게 어울림.
조의	ㅈㅗㅇㅡㅣ	남의 죽음을 슬퍼하는 뜻.
조인	ㅈㅗㅇㅣㄴ	서로 약속하여 만든 문서에 서명을 함.
조작	ㅈㅗㅈㅏㄱ	어떤 일을 사실인 것처럼 꾸며서 만듦.
조장	ㅈㅗㅈㅏㅇ	좋지 않은 일을 더 심해지도록 부추김.
조절	ㅈㅗㅈㅓㄹ	균형에 맞게 바로잡거나 상황에 알맞게 맞춤.
조정	ㅈㅗㅈㅓㅇ	다툼이 있는 사이에 끼어서 서로 화해하게 하거나 타협하여 합의하게 함.
조제	ㅈㅗㅈㅓㅣ	여러 가지 약품을 알맞게 섞어서 약을 지음. 또는 그런 일.
조종	ㅈㅗㅈㅗㅇ	비행기나 배 같은 기계를 다루어 움직이게 함.
조준	ㅈㅗㅈㅜㄴ	총이나 대포 등을 쏠 때 목표물에 정확히 맞도록 방향과 거리를 조절함.
조직	ㅈㅗㅈㅣㄱ	어떤 목표를 이루기 위해 여럿이 모여 체계 있는 집단을 이룸. 또는 그 집단.
조짐	ㅈㅗㅈㅣㅁ	좋거나 나쁜 일이 생길 낌새가 보이는 현상.
조찬	ㅈㅗㅊㅏㄴ	손님을 초대하여 함께 먹는 아침 식사.
조청	ㅈㅗㅊㅓㅇ	묽게 고아서 굳지 않은 엿.
조퇴	ㅈㅗㅌㅗㅣ	학교나 직장 등에서 마치기로 예정된 시간 이전에 나옴.
조판	ㅈㅗㅍㅏㄴ	책이나 신문 등의 인쇄물을 만들어 낼 때, 원고의 지시대로 활자를 구성함. 또는 그런 일.
조폐	ㅈㅗㅍㅕㅣ	동전이나 지폐와 같은 돈을 만듦.
조합	ㅈㅗㅎㅏㅂ	여럿을 한데 모아 한 덩어리로 짬.
조항	ㅈㅗㅎㅏㅇ	법률이나 규정 등의 낱낱의 항목.
조혼	ㅈㅗㅎㅗㄴ	어린 나이에 일찍 결혼함. 또는 그렇게 한 결혼.
조화	ㅈㅗㅎㅗㅏ	남의 죽음을 슬퍼하는 마음을 표현하는 데 쓰는 꽃.
조회	ㅈㅗㅎㅗㅣ	학교나 직장 등에서 지시 사항 전달 등을 위해 아침에 모든 구성원이 한자리에 모이는 일. 또는 그런 모임.
족구	ㅈㅗㄱㄱㅜ	공을 발로 차서 네트를 넘겨 상대편의 땅에 닿으면 점수를 얻는 경기.
족보	ㅈㅗㄱㅂㅗ	한 가문의 계통과 혈통 관계를 기록한 책.
족자	ㅈㅗㄱㅈㅏ	그림이나 글씨 등의 뒷면에 종이나 천을 바르고 양 끝에는 막대기를 대어 벽에 걸거나 말아 둘 수 있도록 만든 것.
졸고	ㅈㅗㄹㄱㅗ	내용이 보잘것없는 원고.
졸도	ㅈㅗㄹㄷㅗ	뇌의 혈액 순환에 문제가 생겨 갑자기 정신을 잃고 쓰러짐. 또는 그런 일.
졸부	ㅈㅗㄹㅂㅜ	갑자기 부자가 된 사람.
졸저	ㅈㅗㄹㅈㅓ	잘 쓰지 못한 글이나 책.
졸지	ㅈㅗㄹㅈㅣ	뜻밖에 갑작스러운 일이 벌어져 있는 상황이나 상태.
종가	ㅈㅗㅇㄱㅏ	어떤 가문에서 큰아들로만 이어져 온 큰집.
종교	ㅈㅗㅇㄱㅛ	신이나 초자연적인 존재를 믿고 복종하면서 생활이나 철학의 기본으로 삼는 문화 체계.
종기	ㅈㅗㅇㄱㅣ	피부의 모공 등에 균이 들어가서 곪아 고름이 생긴 것.
종로	ㅈㅗㅇㄹㅗ	서울특별시 광화문 네거리에서 동대문에 이르는 큰 거리.
종료	ㅈㅗㅇㄹㅛ	어떤 행동이나 일이 끝남. 또는 행동이나 일을 끝마침.
종류	ㅈㅗㅇㄹㅠ	어떤 기준에 따라 여러 가지로 나눈 갈래.
종묘	ㅈㅗㅇㅁㅛ	서울시에 있는, 조선 시대 왕과 왕비의 위패를 모신 사당.
종이	ㅈㅗㅇㅇㅣ	나무를 원료로 하여 얇게 만든, 글씨를 쓰고 그림을 그리고 인쇄를 하는 등 여러 가지 일에 쓰는 물건.
종자	ㅈㅗㅇㅈㅏ	식물에서 나온 씨 또는 씨앗.
종지	ㅈㅗㅇㅈㅣ	간장이나 고추장 등을 담아 상에 놓는 작은 그릇.
종파	ㅈㅗㅇㅍㅏ	한집안의 계통에서 갈라져 나간 집안.
좌시	ㅈㅗㅏㅅㅣ	어떤 사건이나 일에 대해서 참견하지 않고 보기만 함.
좌우	ㅈㅗㅏㅇㅜ	왼쪽과 오른쪽.
좌초	ㅈㅗㅏㅊㅗ	배가 암초에 얹힘.
좌파	ㅈㅗㅏㅍㅏ	진보주의적이거나 급진주의적인 성향을 가진 단체나 정당.
좌표	ㅈㅗㅏㅍㅛ	수학에서 직선, 평면, 공간상의 위치를 나타낸 수치.
죄수	ㅈㅗㅣㅅㅜ	죄를 지어 감옥이나 교도소에 갇힌 사람.
주간	ㅈㅜㄱㅏㄴ	주로 조직이나 단체 등에서 어떤 일을 맡아 책임짐. 또는 그런 사람.
주걱	ㅈㅜㄱㅓㄱ	숟가락과 비슷한 모양의 밥을 푸는 도구.
주검	ㅈㅜㄱㅓㅁ	죽은 사람의 몸.
주격	ㅈㅜㄱㅕㄱ	문장에서 서술어에 대한 주어를 표시하는 격.
주군	ㅈㅜㄱㅜㄴ	왕위가 이어지는 나라에서 나라를 다스리는 왕.
주급	ㅈㅜㄱㅡㅂ	일한 대가로 한 주일마다 지급하는 보수.
주눅	ㅈㅜㄴㅜㄱ	기를 펴지 못하고 움츠러드는 태도.
주님	ㅈㅜㄴㅣㅁ	(높이는 말로) 하나님이나 예수.
주당	ㅈㅜㄷㅏㅇ	술을 좋아하고 잘 마시는 사람들의 무리.
주동	ㅈㅜㄷㅗㅇ	어떤 일에 중심이 되어 움직임.
주둔	ㅈㅜㄷㅜㄴ	군대가 임무를 수행하기 위해 어떤 곳에 얼마 동안 머무름.
주량	ㅈㅜㄹㅑㅇ	마시고 견딜 수 있을 정도의 술의 양.
주력	ㅈㅜㄹㅕㄱ	중심이 되는 힘이나 세력.
주례	ㅈㅜㄹㅕㅣ	결혼식 등에서 식을 맡아 진행하는 일.
주름	ㅈㅜㄹㅡㅁ	피부가 노화되어 생긴 줄. 또는 잔금.
주막	ㅈㅜㅁㅏㄱ	시골 길가에서 밥과 술을 팔고, 돈을 받고 나그네를 묵게 하는 집.
주말	ㅈㅜㅁㅏㄹ	한 주일의 끝.
주먹	ㅈㅜㅁㅓㄱ	손가락을 모두 모아 쥔 손.
주목	ㅈㅜㅁㅗㄱ	관심을 가지고 주의 깊게 살핌. 또는 그 시선.
주몽	ㅈㅜㅁㅗㅇ	고구려의 첫 번째 왕(기원전 58~기원전 19). 알에서 태어났으며, 활을 잘 쏘아 주몽이라는 이름을 갖게 되었다고 전해진다.
주문	ㅈㅜㅁㅜㄴ	귀신을 쫓아내거나 신비한 일을 일으키기 위해 외우는 글귀.
주민	ㅈㅜㅁㅣㄴ	일정한 지역 안에 살고 있는 사람.
주발	ㅈㅜㅂㅏㄹ	위가 약간 벌어지고 뚜껑이 있는, 놋쇠로 만든 밥그릇.
주방	ㅈㅜㅂㅏㅇ	음식을 만들거나 차리는 곳.
주번	ㅈㅜㅂㅓㄴ	한 주일 동안씩 교대로 하는 근무. 또는 그 근무를 서는 사람.
주범	ㅈㅜㅂㅓㅁ	자신의 생각에 따라 범죄를 실제로 저지른 사람.
주벽	ㅈㅜㅂㅕㄱ	술에 취할 때마다 하는 버릇.
주변	ㅈㅜㅂㅕㄴ	일이 잘되도록 중간에서 힘쓰거나 일을 융통성 있게 함. 또는 그런 재주.
주봉	ㅈㅜㅂㅗㅇ	어느 지방이나 산맥 가운데 가장 높은 봉우리.
주빈	ㅈㅜㅂㅣㄴ	손님 가운데서 가장 중요한 손님.
주산	ㅈㅜㅅㅏㄴ	막대에 여러 개의 구슬을 꿰어 만든 도구인 주판을 사용해서 수를 계산함. 또는 그렇게 하는 셈.
주상	ㅈㅜㅅㅏㅇ	왕위가 이어지는 나라에서 나라를 다스리는 왕.
주석	ㅈㅜㅅㅓㄱ	가장 중심이 되는 자리.
주선	ㅈㅜㅅㅓㄴ	다른 사람의 일이 잘 이루어지도록 중간에서 여러 가지 방법으로 힘씀.
주술	ㅈㅜㅅㅜㄹ	불행을 막거나 원하는 일을 이루기 위해 주문을 외거나 신비한 기술을 부리는 일. 또는 그 기술.
주식	ㅈㅜㅅㅣㄱ	밥이나 빵과 같이 끼니에 주가 되는 음식.
주심	ㅈㅜㅅㅣㅁ	등급이나 당락 등을 결정하는 심사에서 중심이 되는 사람.
주업	ㅈㅜㅇㅓㅂ	중심이 되는 직업.
주역	ㅈㅜㅇㅕㄱ	중심이 되는 역할. 또는 중심이 되는 역할을 하는 사람.
주연	ㅈㅜㅇㅕㄴ	연극이나 영화, 드라마 등에서 주인공 역을 맡아 연기하는 일. 또는 주인공 역을 맡은 사람.
주옥	ㅈㅜㅇㅗㄱ	구슬과 옥.
주위	ㅈㅜㅇㅜㅣ	어떤 곳을 둘러싸고 있는 테두리.
주의	ㅈㅜㅇㅡㅣ	굳게 지키는 주장이나 신념.
주인	ㅈㅜㅇㅣㄴ	대상이나 물건을 자기의 것으로 가진 사람.
주일	ㅈㅜㅇㅣㄹ	기독교에서 예배를 드리는 날인 일요일.
주임	ㅈㅜㅇㅣㅁ	직장이나 단체 등에서 어떤 일을 주로 담당함. 또는 그런 사람.
주입	ㅈㅜㅇㅣㅂ	액체나 기체가 흘러 들어가도록 부어 넣음.
주작	ㅈㅜㅈㅏㄱ	네 방위를 맡은 신 중 하나로 남쪽을 지키는 신령을 상징하는, 붉은 봉황 모습의 동물.
주장	ㅈㅜㅈㅏㅇ	군사를 이끄는 장수 가운데 우두머리가 되는 장수.
주재	ㅈㅜㅈㅏㅣ	어떤 일을 중심이 되어 맡아 처리함.
주전	ㅈㅜㅈㅓㄴ	시합, 경기, 싸움 등에서 중심이 되어 싸움. 또는 그런 사람.
주점	ㅈㅜㅈㅓㅁ	술을 파는 집.
주접	ㅈㅜㅈㅓㅂ	차림새가 초라하고 지저분함.
주정	ㅈㅜㅈㅓㅇ	술에 취해 보기에 좋지 않은 말이나 행동을 함. 또는 그런 말이나 행동.
주제	ㅈㅜㅈㅓㅣ	대화나 연구 등에서 중심이 되는 문제.
주종	ㅈㅜㅈㅗㅇ	여러 가지 가운데 중심이 되는 것.
주중	ㅈㅜㅈㅜㅇ	일주일 중 주말이 아닌 날.
주창	ㅈㅜㅊㅏㅇ	사상, 이론, 주의 등을 앞장서서 주장함.
주체	ㅈㅜㅊㅓㅣ	부담스럽거나 귀찮은 것을 잘 처리함.
주총	ㅈㅜㅊㅗㅇ	‘주주 총회’를 줄여 이르는 말.
주최	ㅈㅜㅊㅗㅣ	행사나 모임을 책임지고 맡아 기획하여 엶.
주축	ㅈㅜㅊㅜㄱ	전체 가운데서 중심이 되어 영향을 미치는 사람이나 대상.
주판	ㅈㅜㅍㅏㄴ	수를 계산하는 데에 쓰는, 막대에 구슬들을 꿰어 만든 도구.
주필	ㅈㅜㅍㅣㄹ	신문사나 잡지사 등에서 책의 편집을 책임지는 사람. 또는 그러한 직위.
주한	ㅈㅜㅎㅏㄴ	외국의 관리나 기관, 군대로서 한국에 머물러 있거나 살고 있음.
주해	ㅈㅜㅎㅏㅣ	본문의 뜻을 알기 쉽게 풀이함. 또는 그런 글.
주홍	ㅈㅜㅎㅗㅇ	붉은빛을 띤 빨강과 노랑의 중간색.
주화	ㅈㅜㅎㅗㅏ	쇠 등을 녹여서 만든 화폐.
죽기	ㅈㅜㄱㄱㅣ	대나무로 만든 그릇.
죽지	ㅈㅜㄱㅈㅣ	팔과 어깨가 이어진 부분.
준거	ㅈㅜㄴㄱㅓ	사물의 정도나 성격 등을 알기 위한 근거나 기준.
준마	ㅈㅜㄴㅁㅏ	빠르게 잘 달리는 좋은 말.
준비	ㅈㅜㄴㅂㅣ	미리 마련하여 갖춤.
준수	ㅈㅜㄴㅅㅜ	명령이나 규칙, 법률 등을 지킴.
준치	ㅈㅜㄴㅊㅣ	등은 어두운 청색이고 배는 은백색이며, 밴댕이와 비슷하게 생긴, 바다에 사는 물고기.
줄기	ㅈㅜㄹㄱㅣ	식물을 받치고 뿌리에서 빨아들인 수분이나 양분을 나르며, 잎이나 가지, 열매 등이 붙는 부분.
줄자	ㅈㅜㄹㅈㅏ	헝겊, 비닐, 강철 등으로 띠처럼 만든 자.
줄표	ㅈㅜㄹㅍㅛ	이미 말한 내용을 다른 말로 설명을 덧붙이거나 보충할 때에 쓰는 문장 부호 ‘―’의 이름.
중고	ㅈㅜㅇㄱㅗ	새것이 아니라 사용한 흔적이 있음. 또는 나오거나 만든 지 오래됨.
중기	ㅈㅜㅇㄱㅣ	어떤 기간의 중간이 되는 시기.
중도	ㅈㅜㅇㄷㅗ	일이 진행되고 있는 사이.
중류	ㅈㅜㅇㄹㅠ	흐르는 강이나 냇물의 중간 부분.
중부	ㅈㅜㅇㅂㅜ	어떤 지역의 가운데 부분.
중사	ㅈㅜㅇㅅㅏ	군대에서 상사의 아래, 하사의 위인 급. 또는 그 계급에 있는 군인.
중소	ㅈㅜㅇㅅㅗ	규모나 수준 등이 중간이거나 그 이하인 것.
중수	ㅈㅜㅇㅅㅜ	오래된 건물의 낡고 헌 부분을 손질하여 고침.
중시	ㅈㅜㅇㅅㅣ	매우 크고 중요하게 여김.
중요	ㅈㅜㅇㅇㅛ	귀중하고 꼭 필요함.
중지	ㅈㅜㅇㅈㅣ	하던 일을 중간에 멈추거나 그만둠.
중추	ㅈㅜㅇㅊㅜ	어떤 것의 중심이 되는 중요한 부분.
쥐치	ㅈㅜㅣㅊㅣ	마름모 모양인 푸른 갈색 또는 분홍색 몸통에 어두운 갈색 무늬가 있고 옆으로 납작한 바닷물고기.
쥐포	ㅈㅜㅣㅍㅗ	말린 쥐치를 기계로 납작하게 눌러 만든 음식.
즉사	ㅈㅡㄱㅅㅏ	그 자리에서 바로 죽음.
즉시	ㅈㅡㄱㅅㅣ	어떤 일이 벌어진 바로 그때.
즉효	ㅈㅡㄱㅎㅛ	약 등을 먹거나 발랐을 때 바로 나타나는 좋은 반응.
증가	ㅈㅡㅇㄱㅏ	수나 양이 더 늘어나거나 많아짐.
증거	ㅈㅡㅇㄱㅓ	어떤 사건이나 사실을 확인할 수 있는 근거.
증기	ㅈㅡㅇㄱㅣ	기체 상태로 되어 있는 물.
증류	ㅈㅡㅇㄹㅠ	액체에 열을 가하여 생긴 기체를 차갑게 식혀서 다시 액체로 만드는 일.
증보	ㅈㅡㅇㅂㅗ	출판된 책이나 글 등에 모자란 내용을 더 보탬.
증서	ㅈㅡㅇㅅㅓ	권리, 의무, 사실 등을 증명하는 문서.
증시	ㅈㅡㅇㅅㅣ	‘증권 시장’을 줄여 이르는 말.
증여	ㅈㅡㅇㅇㅕ	재산을 아무런 대가도 없이 다른 사람에게 넘겨줌.
증오	ㅈㅡㅇㅇㅗ	몹시 원망하고 미워함.
증자	ㅈㅡㅇㅈㅏ	자본을 늘림.
증조	ㅈㅡㅇㅈㅗ	아버지의 할아버지.
증표	ㅈㅡㅇㅍㅛ	어떠한 사실이나 사건을 증명하거나 증거가 되는 표.
증후	ㅈㅡㅇㅎㅜ	병을 앓을 때 나타나는 여러 가지 상태나 모양.
지각	ㅈㅣㄱㅏㄱ	사물의 이치를 깨닫는 능력.
지갑	ㅈㅣㄱㅏㅂ	돈, 카드, 명함 등을 넣어 가지고 다닐 수 있게 가죽이나 헝겊 등으로 만든 물건.
지게	ㅈㅣㄱㅓㅣ	나무로 등에 짐을 질 수 있도록 만든 한국 고유의 운반 도구.
지경	ㅈㅣㄱㅕㅇ	나라나 지역 등의 구간을 가르는 경계.
지국	ㅈㅣㄱㅜㄱ	본사나 본 방송국 등에서 갈라져 나가 일정한 지역에서 관련 사무를 맡아 하는 곳.
지금	ㅈㅣㄱㅡㅁ	말을 하고 있는 바로 이때.
지급	ㅈㅣㄱㅡㅂ	돈이나 물건을 정해진 만큼 내줌.
지능	ㅈㅣㄴㅡㅇ	사물이나 상황을 이해하고 대처하는 지적인 적응 능력.
지단	ㅈㅣㄷㅏㄴ	달걀의 흰자와 노른자를 따로 갈라서 얇게 부친 고명.
지대	ㅈㅣㄷㅏㅣ	일정한 구역의 땅.
지랄	ㅈㅣㄹㅏㄹ	(속된 말로) 마구 소란스럽고 분별없이 하는 행동.
지략	ㅈㅣㄹㅑㄱ	어떤 일이나 문제를 날카롭게 분석하여 해결책을 세우는 뛰어난 능력이나 방법.
지령	ㅈㅣㄹㅕㅇ	상부 조직이 하부 조직에게 지시나 명령을 내림. 또는 그 지시나 명령.
지론	ㅈㅣㄹㅗㄴ	전부터 늘 주장해 온 생각이나 이론.
지뢰	ㅈㅣㄹㅗㅣ	땅속에 묻어 두고 차나 사람이 그 위를 지나가면 폭발하도록 만든 폭약.
지름	ㅈㅣㄹㅡㅁ	원이나 구의 둘레 위의 두 점이 중심을 지나도록 직선으로 이은 선.
지망	ㅈㅣㅁㅏㅇ	어떤 전공이나 직업 등을 갖기를 바람. 또는 그렇게 바라는 전공이나 직업.
지면	ㅈㅣㅁㅕㄴ	땅의 바닥.
지명	ㅈㅣㅁㅕㅇ	마을이나 지방, 지역 등의 이름.
지목	ㅈㅣㅁㅗㄱ	특정 사람이나 사물이 어떠하다고 꼭 집어서 가리킴.
지문	ㅈㅣㅁㅜㄴ	교과서나 시험 문제 등에서 주어진 내용의 글.
지반	ㅈㅣㅂㅏㄴ	땅의 표면.
지방	ㅈㅣㅂㅏㅇ	행정 구획이나 어떤 특징 등에 의해 나누어지는 지역.
지배	ㅈㅣㅂㅏㅣ	어떤 사람이나 집단을 자신의 뜻대로 복종하게 하여 다스리거나 차지함.
지병	ㅈㅣㅂㅕㅇ	오랫동안 잘 낫지 않는 병.
지분	ㅈㅣㅂㅜㄴ	여러 사람들이 공동으로 소유한 물건이나 재산에서, 소유자들이 각자 가지는 몫. 또는 그런 비율.
지불	ㅈㅣㅂㅜㄹ	돈을 내거나 값을 치름.
지붕	ㅈㅣㅂㅜㅇ	집의 윗부분을 덮는 덮개.
지상	ㅈㅣㅅㅏㅇ	땅 위.
지석	ㅈㅣㅅㅓㄱ	죽은 사람에 관한 정보나 무덤이 있는 곳을 적어 무덤 앞이나 옆에 묻는 돌.
지성	ㅈㅣㅅㅓㅇ	지극한 정성.
지세	ㅈㅣㅅㅓㅣ	땅의 생긴 모양.
지속	ㅈㅣㅅㅗㄱ	어떤 일이나 상태가 오래 계속됨. 또는 어떤 일이나 상태를 오래 계속함.
지식	ㅈㅣㅅㅣㄱ	어떤 대상에 대하여 배우거나 직접 경험하여 알게 된 내용.
지압	ㅈㅣㅇㅏㅂ	몸의 한 부분을 손가락으로 누르거나 주무름.
지양	ㅈㅣㅇㅑㅇ	더 발전된 단계로 나아가기 위하여 어떤 것을 하지 않음.
지역	ㅈㅣㅇㅕㄱ	어떤 특징이나 일정한 기준에 따라 범위를 나눈 땅.
지연	ㅈㅣㅇㅕㄴ	태어났거나 사는 지역에 의해 맺어지는 인간관계.
지열	ㅈㅣㅇㅕㄹ	지구 안에 원래 있는 열.
지엽	ㅈㅣㅇㅕㅂ	식물의 가지와 잎.
지옥	ㅈㅣㅇㅗㄱ	살아 있을 때 죄를 지은 사람이 죽은 뒤에 가서 벌을 받는다는 곳.
지위	ㅈㅣㅇㅜㅣ	사회적 신분에 따른 계급이나 위치.
지읒	ㅈㅣㅇㅡㅈ	한글 자모 ‘ㅈ’의 이름.
지인	ㅈㅣㅇㅣㄴ	아는 사람.
지장	ㅈㅣㅈㅏㅇ	일에 나쁜 영향을 주거나 방해가 되는 장애.
지적	ㅈㅣㅈㅓㄱ	지식이나 지성에 관한 것.
지점	ㅈㅣㅈㅓㅁ	본점에서 따로 갈라져 나온 점포.
지정	ㅈㅣㅈㅓㅇ	가리켜 분명하게 정함.
지존	ㅈㅣㅈㅗㄴ	(높이는 말로) 임금.
지진	ㅈㅣㅈㅣㄴ	화산 활동이나 땅속의 큰 변화 때문에 땅이 흔들리는 현상.
지질	ㅈㅣㅈㅣㄹ	지구 표면을 이루고 있는 암석이나 땅의 성질이나 상태.
지참	ㅈㅣㅊㅏㅁ	모임 등에 무엇을 지니고 참여함.
지척	ㅈㅣㅊㅓㄱ	아주 가까운 거리.
지천	ㅈㅣㅊㅓㄴ	신분 등이 매우 천함.
지체	ㅈㅣㅊㅓㅣ	시간을 늦추거나 질질 끎.
지축	ㅈㅣㅊㅜㄱ	북극과 남극을 연결하는 지구의 자전축.
지출	ㅈㅣㅊㅜㄹ	어떤 목적으로 돈을 씀. 또는 그렇게 쓰는 돈.
지층	ㅈㅣㅊㅡㅇ	자갈, 모래, 진흙, 화산재 등이 오랜 시간 동안 쌓여 이루어진 층.
지침	ㅈㅣㅊㅣㅁ	나침반이나 계기판, 시계 등에 달려 있는 바늘.
지칭	ㅈㅣㅊㅣㅇ	어떤 대상을 가리켜 이르는 일. 또는 그런 이름.
지탄	ㅈㅣㅌㅏㄴ	잘못을 꼭 집어 비난함.
지평	ㅈㅣㅍㅕㅇ	넓고 평평한 땅.
지폐	ㅈㅣㅍㅕㅣ	종이로 만든 돈.
지향	ㅈㅣㅎㅑㅇ	어떤 목적이나 목표에 뜻을 둠. 또는 그렇게 하려는 의지.
지혈	ㅈㅣㅎㅕㄹ	나오는 피를 멈추게 함.
지형	ㅈㅣㅎㅕㅇ	땅의 생긴 모양.
지혜	ㅈㅣㅎㅕㅣ	삶의 이치와 옳고 그름을 잘 이해하고 판단하는 능력.
지휘	ㅈㅣㅎㅜㅣ	목적을 효과적으로 이루기 위해 단체의 행동을 다스림.
직구	ㅈㅣㄱㄱㅜ	야구에서, 투수가 변화를 주지 않고 곧게 던지는 공.
직녀	ㅈㅣㄱㄴㅕ	견우와 직녀 이야기에 나오는, 베를 짜는 일을 하는 여자. 은하수를 사이에 두고 남편 견우와 헤어져 있다가 일 년에 단 한 번, 음력 7월 7일에 까치와 까마귀가 놓아 준 다리인 오작교에서 견우와 만날 수 있다고 한다.
직류	ㅈㅣㄱㄹㅠ	곧게 흐름.
직무	ㅈㅣㄱㅁㅜ	직업상 맡은 일.
직시	ㅈㅣㄱㅅㅣ	정신을 집중하여 어떤 대상을 똑바로 봄.
직조	ㅈㅣㄱㅈㅗ	기계나 베틀 등으로 천을 짜는 일.
직후	ㅈㅣㄱㅎㅜ	어떤 일이 일어난 바로 뒤.
진가	ㅈㅣㄴㄱㅏ	참된 값어치.
진노	ㅈㅣㄴㄴㅗ	몹시 화를 내며 노여워함. 또는 그런 감정.
진도	ㅈㅣㄴㄷㅗ	일이 진행되는 속도나 정도.
진두	ㅈㅣㄴㄷㅜ	군대에서, 전투 대형의 맨 앞.
진로	ㅈㅣㄴㄹㅗ	앞으로 나아갈 길.
진료	ㅈㅣㄴㄹㅛ	의사가 환자를 진찰하고 치료함.
진리	ㅈㅣㄴㄹㅣ	참된 이치. 또는 참된 도리.
진미	ㅈㅣㄴㅁㅣ	음식의 아주 좋은 맛. 또는 아주 맛이 좋은 음식.
진보	ㅈㅣㄴㅂㅗ	정도나 수준이 나아지거나 높아짐.
진부	ㅈㅣㄴㅂㅜ	참과 거짓. 또는 진짜와 가짜.
진수	ㅈㅣㄴㅅㅜ	사물이나 현상의 가장 중요하고 근본적인 부분.
진자	ㅈㅣㄴㅈㅏ	줄 끝에 추를 매달아 옆으로 흔들리며 움직이게 만든 물체.
진주	ㅈㅣㄴㅈㅜ	진주조개의 조가비나 살 속에 생기는, 아름다운 광택이 나는 보석.
진지	ㅈㅣㄴㅈㅣ	(높임말로) 밥.
진토	ㅈㅣㄴㅌㅗ	티끌과 흙.
진피	ㅈㅣㄴㅍㅣ	척추동물의 가장 바깥쪽 피부 아래에서 피부를 형성하며, 모세 혈관과 신경이 들어 있는 조직.
질부	ㅈㅣㄹㅂㅜ	조카의 아내.
질서	ㅈㅣㄹㅅㅓ	많은 사람들이 모인 곳에서 혼란스럽지 않도록 지키는 순서나 차례.
질소	ㅈㅣㄹㅅㅗ	상온에서 기체 상태로 존재하며 공기의 약 78%를 이루는, 색깔이나 냄새, 맛이 없는 원소.
질시	ㅈㅣㄹㅅㅣ	밉게 봄.
질주	ㅈㅣㄹㅈㅜ	매우 빨리 달림.
질타	ㅈㅣㄹㅌㅏ	큰 소리로 잘못을 나무람.
질투	ㅈㅣㄹㅌㅜ	부부나 애인 사이에서 상대방이 다른 사람을 좋아할 경우에 지나치게 미워하고 싫어함.
짐차	ㅈㅣㅁㅊㅏ	주로 화물을 실어 나르는 자동차.
집기	ㅈㅣㅂㄱㅣ	집 안이나 사무실 등에서 쓰는 온갖 기구.
집도	ㅈㅣㅂㄷㅗ	수술이나 해부를 하기 위하여 수술용 칼을 잡음.
집무	ㅈㅣㅂㅁㅜ	사무를 실제로 해 나감.
집사	ㅈㅣㅂㅅㅏ	집주인을 가까이 모시면서 그 집의 일을 맡아보는 사람.
집시	ㅈㅣㅂㅅㅣ	헝가리를 중심으로 유럽, 서부 아시아, 아프리카, 미국에 퍼져 사는 유랑 민족.
집터	ㅈㅣㅂㅌㅓ	집이 있던 자리 또는 집이 있는 자리나, 집을 지을 자리.
징수	ㅈㅣㅇㅅㅜ	나라, 공공 단체, 지주 등이 돈, 곡식, 물품 등을 거두어들임.
징조	ㅈㅣㅇㅈㅗ	어떤 일이 일어날 것 같은 분위기나 느낌.
징표	ㅈㅣㅇㅍㅛ	어떤 것의 특별하거나 다른 점을 드러내 보이는 특징.
징후	ㅈㅣㅇㅎㅜ	어떤 일이 일어났거나 일어날 것을 나타내는 현상.
쪼다	ㅈㅈㅗㄷㅏ	(속된 말로) 조금 어리석고 모자라 자기가 마땅히 해야 할 일을 못하는 사람. 또는 그런 태도나 행동.
차남	ㅊㅏㄴㅏㅁ	둘째 아들.
차단	ㅊㅏㄷㅏㄴ	액체나 기체 등의 흐름을 막거나 끊어서 통하지 못하게 함.
차돌	ㅊㅏㄷㅗㄹ	빛깔이 희고 유리 광택이 있는 단단한 돌.
차등	ㅊㅏㄷㅡㅇ	고르거나 가지런하지 않고 차별이 있음. 또는 그렇게 대함.
차량	ㅊㅏㄹㅑㅇ	도로나 선로 위를 달리는 모든 차.
차렷	ㅊㅏㄹㅕㅅ	몸과 정신을 바로 하여 움직이지 않고 똑바로 서 있는 자세를 취하라는 구령에 따라 행하는 동작.
차례	ㅊㅏㄹㅕㅣ	어떤 일을 하거나 어떤 일이 일어나는 순서.
차림	ㅊㅏㄹㅣㅁ	옷이나 물건 등으로 꾸며서 갖춘 상태.
차명	ㅊㅏㅁㅕㅇ	남의 이름을 빌려 씀. 또는 빌려 쓴 이름.
차반	ㅊㅏㅂㅏㄴ	차를 달여 마시는 데에 쓰는 그릇이나 숟가락 등을 담는 조그마한 쟁반.
차별	ㅊㅏㅂㅕㄹ	둘 이상을 차등을 두어 구별함.
차선	ㅊㅏㅅㅓㄴ	최선의 다음.
차압	ㅊㅏㅇㅏㅂ	→ 압류
차양	ㅊㅏㅇㅑㅇ	햇볕이나 비를 막기 위해 처마나 창문 끝에 덧붙이는 물건.
차용	ㅊㅏㅇㅛㅇ	돈이나 물건 등을 빌려서 씀.
차익	ㅊㅏㅇㅣㄱ	물건을 사고판 결과나 가격, 시세의 변동으로 생기는 이익.
차일	ㅊㅏㅇㅣㄹ	햇볕을 가리기 위하여 치는 포장.
차입	ㅊㅏㅇㅣㅂ	돈이나 물건을 외부에서 빌림.
차장	ㅊㅏㅈㅏㅇ	관공서나 회사 등에서 가장 높은 장 다음가는 직위. 또는 그 직위에 있는 사람.
차제	ㅊㅏㅈㅓㅣ	때마침 주어진 기회.
차종	ㅊㅏㅈㅗㅇ	자동차나 철도 차량 등의 종류.
차질	ㅊㅏㅈㅣㄹ	일이 정상적으로 이루어지지 않고 늦어지거나 틀어짐.
차창	ㅊㅏㅊㅏㅇ	기차나 자동차 등에 달린 창문.
차체	ㅊㅏㅊㅓㅣ	자동차나 기차 등의 몸체.
차출	ㅊㅏㅊㅜㄹ	어떤 일을 시키기 위하여 사람을 뽑음.
차편	ㅊㅏㅍㅕㄴ	물건을 옮기거나 사람이 이동하기 위해 차를 이용하는 기회나 수단.
착수	ㅊㅏㄱㅅㅜ	새로운 일을 시작함.
착시	ㅊㅏㄱㅅㅣ	착각하여 잘못 보는 현상.
착오	ㅊㅏㄱㅇㅗ	착각을 하여 생각이나 행동을 잘못함. 또는 그런 잘못.
착지	ㅊㅏㄱㅈㅣ	공중에서 땅으로 내림. 또는 그런 곳.
찬가	ㅊㅏㄴㄱㅏ	아름답거나 훌륭한 것을 칭찬하고 기리는 노래나 글.
찬기	ㅊㅏㄴㄱㅣ	차가운 기운.
찬미	ㅊㅏㄴㅁㅣ	아름답고 훌륭한 것 등을 높여 말하며 칭찬함.
찬비	ㅊㅏㄴㅂㅣ	차가운 비.
찬사	ㅊㅏㄴㅅㅏ	훌륭함을 드러내어 칭찬하는 말이나 글.
찬조	ㅊㅏㄴㅈㅗ	어떤 일에 뜻을 같이하여 도와줌.
찰나	ㅊㅏㄹㄴㅏ	어떤 일이나 현상이 일어나는 바로 그때.
찰벼	ㅊㅏㄹㅂㅕ	낟알에 끈기가 있는 벼.
참가	ㅊㅏㅁㄱㅏ	모임이나 단체, 경기, 행사 등의 자리에 가서 함께함.
참고	ㅊㅏㅁㄱㅗ	살펴 생각하여 도움을 얻음.
참모	ㅊㅏㅁㅁㅗ	윗사람의 곁에서 의견을 내어 도움. 또는 그런 사람.
참사	ㅊㅏㅁㅅㅏ	비참하고 끔찍한 일.
참여	ㅊㅏㅁㅇㅕ	여러 사람이 같이 하는 어떤 일에 끼어들어 함께 일함.
참조	ㅊㅏㅁㅈㅗ	어떤 일을 그와 관련된 다른 일과 참고로 비교하고 대조해 봄.
참치	ㅊㅏㅁㅊㅣ	몸은 3미터 정도이고 등이 푸르며 살이 검붉은, 주로 회나 통조림으로 먹는 바닷물고기.
참호	ㅊㅏㅁㅎㅗ	야외 전투에서 적의 공격을 막고 몸을 숨기기 위하여 땅에 판 구덩이.
창가	ㅊㅏㅇㄱㅏ	창문과 가까운 곳이나 옆.
창고	ㅊㅏㅇㄱㅗ	여러 가지 물건을 모아 두거나 넣어 두는 곳.
창구	ㅊㅏㅇㄱㅜ	안과 밖의 의사소통이 가능하도록 창을 내거나 뚫어 놓은 곳.
창녀	ㅊㅏㅇㄴㅕ	몸을 파는 것이 직업인 여자.
창시	ㅊㅏㅇㅅㅣ	어떤 일이나 사상, 학설 등을 처음 시작하거나 내세움.
창자	ㅊㅏㅇㅈㅏ	사람이나 동물의 큰창자와 작은창자.
창조	ㅊㅏㅇㅈㅗ	전에 없던 것을 처음으로 만들거나 새롭게 이룩함.
창포	ㅊㅏㅇㅍㅗ	온몸에 향기가 있고 여름에 꽃이 피며, 뿌리는 약으로 쓰거나 단오에 머리를 감는 데에 쓰는 식물.
창피	ㅊㅏㅇㅍㅣ	체면이 깎이는 어떤 일이나 사실 때문에 몹시 부끄러움.
채도	ㅊㅏㅣㄷㅗ	색의 산뜻하고 뚜렷한 정도.
채무	ㅊㅏㅣㅁㅜ	어떤 사람이 다른 사람에게 어떤 행위를 해야 할 의무.
채비	ㅊㅏㅣㅂㅣ	어떤 일을 위해 필요한 물건이나 자세 등이 미리 갖추어지거나 그렇게 되게 함. 또는 그 물건이나 자세.
채소	ㅊㅏㅣㅅㅗ	밭에서 기르며 주로 그 잎이나 줄기, 열매를 먹는 농작물.
처남	ㅊㅓㄴㅏㅁ	아내의 남동생을 이르거나 부르는 말.
처단	ㅊㅓㄷㅏㄴ	결정적인 판단을 내려 처치하거나 처리함.
처방	ㅊㅓㅂㅏㅇ	병을 치료하기 위해 약을 짓는 방법.
처벌	ㅊㅓㅂㅓㄹ	범죄를 저지른 사람에게 국가나 특정 기관이 제재나 벌을 줌. 또는 그러한 벌.
처분	ㅊㅓㅂㅜㄴ	물건이나 재산 등을 처리하여 치움.
처세	ㅊㅓㅅㅓㅣ	사람들과 사귀며 세상을 살아감. 또는 그런 일.
처신	ㅊㅓㅅㅣㄴ	세상을 살아나가는 데 필요한 몸가짐이나 행동.
처음	ㅊㅓㅇㅡㅁ	차례나 시간상으로 맨 앞.
처장	ㅊㅓㅈㅏㅇ	행정 기관이나 사무 부서의 하나인 처의 책임자.
처제	ㅊㅓㅈㅓㅣ	아내의 여동생을 이르거나 부르는 말.
처첩	ㅊㅓㅊㅓㅂ	아내와 첩.
처형	ㅊㅓㅎㅕㅇ	아내의 언니를 이르거나 부르는 말.
척도	ㅊㅓㄱㄷㅗ	자로 재는 길이의 표준.
척수	ㅊㅓㄱㅅㅜ	척추의 뼈 속에 있는, 신경 세포가 모인 부분.
척추	ㅊㅓㄱㅊㅜ	머리 아래에서 엉덩이 부위까지의 뼈가 줄지어 있는 신체 부위.
천거	ㅊㅓㄴㄱㅓ	사람을 소개하거나 추천함.
천고	ㅊㅓㄴㄱㅗ	아주 먼 옛날.
천기	ㅊㅓㄴㄱㅣ	하늘에 나타난 낌새.
천도	ㅊㅓㄴㄷㅗ	수도를 옮김.
천리	ㅊㅓㄴㄹㅣ	만물에 작용하는 자연의 이치. 또는 하늘의 바른 도리.
천부	ㅊㅓㄴㅂㅜ	기독교에서, 삼위일체 중 하나인 하나님 아버지.
천사	ㅊㅓㄴㅅㅏ	하늘에서 내려와 인간에게 신의 뜻을 전하며 신과 인간을 이어 주는 심부름꾼.
천시	ㅊㅓㄴㅅㅣ	낮추어 보거나 천하게 여김.
천지	ㅊㅓㄴㅈㅣ	하늘과 땅.
천추	ㅊㅓㄴㅊㅜ	오래고 긴 세월. 또는 먼 미래.
천치	ㅊㅓㄴㅊㅣ	어리석고 못난 사람.
천하	ㅊㅓㄴㅎㅏ	하늘 아래 온 세상. 또는 한 나라 전체.
철거	ㅊㅓㄹㄱㅓ	건물이나 시설을 무너뜨려 없애거나 걷어치움.
철교	ㅊㅓㄹㄱㅛ	철로 만든 다리.
철기	ㅊㅓㄹㄱㅣ	쇠로 만든 그릇이나 도구.
철도	ㅊㅓㄹㄷㅗ	기차나 전차 등이 다니는 쇠로 만든 길.
철로	ㅊㅓㄹㄹㅗ	기차, 전차 등이 다니는 쇠로 만든 길.
철마	ㅊㅓㄹㅁㅏ	(비유적으로) 쇠로 만든 말이라는 뜻으로, 기차.
철모	ㅊㅓㄹㅁㅗ	전투할 때 총알이나 포탄의 파편으로부터 머리를 보호하기 위해 쓰는 모자.
철사	ㅊㅓㄹㅅㅏ	쇠로 만든 가는 줄.
철수	ㅊㅓㄹㅅㅜ	있던 곳에서 시설이나 장비 등을 거두어 가지고 물러남.
철야	ㅊㅓㄹㅇㅑ	어떤 일 때문에 잠을 자지 않고 밤을 보냄.
철자	ㅊㅓㄹㅈㅏ	자음과 모음을 맞추어 하나의 글자를 만드는 일. 또는 그렇게 만든 글자.
철저	ㅊㅓㄹㅈㅓ	어떤 일을 하는 데 있어서 매우 조심하여 부족함이 없이 완벽함.
첨가	ㅊㅓㅁㄱㅏ	이미 있는 것에 새로운 것을 덧붙이거나 보탬.
첨부	ㅊㅓㅁㅂㅜ	서류나 편지 등에 그와 관련된 문서를 덧붙임.
첩보	ㅊㅓㅂㅂㅗ	상대의 정보나 형편을 몰래 알아내어 자기 편에 알리는 것. 또는 그런 알림.
첩자	ㅊㅓㅂㅈㅏ	다른 나라나 단체의 비밀스러운 정보를 알아내어 자신의 나라나 단체에 넘겨주는 일을 하는 사람.
첫차	ㅊㅓㅅㅊㅏ	그날의 맨 처음 떠나는 차.
청구	ㅊㅓㅇㄱㅜ	다른 사람에게 돈이나 물건 등을 달라고 요구함.
청사	ㅊㅓㅇㅅㅏ	역사상의 기록.
청소	ㅊㅓㅇㅅㅗ	더럽고 지저분한 것을 깨끗하게 치움.
청유	ㅊㅓㅇㅇㅠ	말하는 사람이 듣는 사람에게 어떤 것을 같이 하자고 요청함. 또는 그런 일.
청자	ㅊㅓㅇㅈㅏ	진흙을 빚어 유약을 발라 높은 열로 구운, 푸른빛을 띠는 자기.
청주	ㅊㅓㅇㅈㅜ	다 익은 술에서 맑은 부분만 떠낸 술.
체구	ㅊㅓㅣㄱㅜ	몸의 크기나 부피.
체류	ㅊㅓㅣㄹㅠ	집을 떠나 어떤 곳에 가서 머물러 있음.
체모	ㅊㅓㅣㅁㅗ	몸에 난 털.
체스	ㅊㅓㅣㅅㅡ	장기와 비슷한 서양 놀이.
체조	ㅊㅓㅣㅈㅗ	일정한 형식에 맞게 몸을 움직임. 또는 그런 운동.
체코	ㅊㅓㅣㅋㅗ	유럽 중부에 있는 나라. 중공업이 발달하였으며, 주요 생산물로는 밀, 포도 등이 있다. 주요 언어는 체코어이고 수도는 프라하이다.
체크	ㅊㅓㅣㅋㅡ	어떤 물건이나 일 등의 상태를 검사함.
체포	ㅊㅓㅣㅍㅗ	죄를 지었거나 죄를 지었을 것으로 의심되는 사람을 잡음.
초경	ㅊㅗㄱㅕㅇ	하룻밤을 다섯으로 나눈 오경의 첫째 부분으로, 저녁 일곱 시부터 아홉 시 사이.
초과	ㅊㅗㄱㅗㅏ	일정한 기준을 넘음.
초급	ㅊㅗㄱㅡㅂ	가장 처음이거나 가장 낮거나 쉬운 등급이나 단계.
초년	ㅊㅗㄴㅕㄴ	사람의 일생에서 초기인 젊은 시절.
초대	ㅊㅗㄷㅏㅣ	어떤 자리나 지위가 이어질 때 그 첫 번째.
초동	ㅊㅗㄷㅗㅇ	어떤 일을 할 때, 맨 처음에 하는 행동.
초등	ㅊㅗㄷㅡㅇ	단계가 있는 데서 맨 처음 등급. 또는 맨 아래 등급.
초래	ㅊㅗㄹㅏㅣ	어떤 결과를 가져오게 함.
초례	ㅊㅗㄹㅕㅣ	전통적으로 치르는 결혼식.
초록	ㅊㅗㄹㅗㄱ	글이나 책에서 필요한 부분만을 뽑아서 적음. 또는 그런 기록.
초롱	ㅊㅗㄹㅗㅇ	옛날에 촛불이나 등잔불을 넣어 달아 두거나 들고 다니던 등.
초막	ㅊㅗㅁㅏㄱ	풀이나 짚으로 지붕 위를 덮어 조그마하게 지은 집.
초면	ㅊㅗㅁㅕㄴ	처음으로 대하는 얼굴. 또는 처음 만나는 형편.
초목	ㅊㅗㅁㅗㄱ	풀과 나무.
초반	ㅊㅗㅂㅏㄴ	어떤 일이나 일정한 기간의 처음 단계.
초밥	ㅊㅗㅂㅏㅂ	식초와 소금으로 간을 하여 작게 뭉친 흰밥에 생선을 얹거나 김, 유부 등으로 싸서 만든 일본 음식.
초벌	ㅊㅗㅂㅓㄹ	같은 일을 이어서 여러 차례 할 때에 맨 처음 대강 하여 낸 차례.
초범	ㅊㅗㅂㅓㅁ	처음으로 죄를 지음. 또는 그런 사람.
초병	ㅊㅗㅂㅕㅇ	초소를 지키며 경계와 감시를 하는 병사.
초복	ㅊㅗㅂㅗㄱ	음력 6월에서 7월에 있는 삼복 가운데 첫 번째 날. 이날은 더위를 이기기 위해 계곡을 찾아 물놀이를 즐기거나 보신탕 또는 삼계탕을 먹는다.
초본	ㅊㅗㅂㅗㄴ	원본에서 필요한 부분만 뽑아내어 베낀 문서.
초봄	ㅊㅗㅂㅗㅁ	이른 봄.
초빙	ㅊㅗㅂㅣㅇ	정식으로 예를 갖추어 불러들임.
초산	ㅊㅗㅅㅏㄴ	사람이나 동물이 처음으로 아이나 새끼를 낳음.
초상	ㅊㅗㅅㅏㅇ	사람이 죽어서 장례를 치를 때까지의 일.
초석	ㅊㅗㅅㅓㄱ	기둥의 밑에 기초로 받쳐 놓은 돌.
초선	ㅊㅗㅅㅓㄴ	처음이나 첫 번째로 뽑힘. 또는 처음이나 첫 번째로 뽑음.
초성	ㅊㅗㅅㅓㅇ	음절의 구성에서 처음 소리인 자음.
초속	ㅊㅗㅅㅗㄱ	일 초를 기준으로 잰 속도.
초순	ㅊㅗㅅㅜㄴ	한 달 가운데 1일부터 10일까지의 기간.
초식	ㅊㅗㅅㅣㄱ	주로 풀이나 채소, 나물만 먹고 삶. 또는 그 풀이나 채소, 나물.
초심	ㅊㅗㅅㅣㅁ	처음에 먹은 마음.
초안	ㅊㅗㅇㅏㄴ	원고나 문서 등을 처음 대강 적음. 또는 그 원고나 문서.
초연	ㅊㅗㅇㅕㄴ	연극이나 무용 등의 공연을 처음으로 무대에 올려 관객에게 보임. 또는 그 공연.
초엽	ㅊㅗㅇㅕㅂ	한 시대를 처음, 가운데, 끝의 세 부분으로 나눌 때 그 처음 부분.
초인	ㅊㅗㅇㅣㄴ	사람이라고 생각할 수 없을 만큼 아주 뛰어난 능력을 가진 사람.
초임	ㅊㅗㅇㅣㅁ	처음으로 어떤 직위나 직무를 맡음. 또는 그 직위나 직무.
초입	ㅊㅗㅇㅣㅂ	문이나 길 등에 들어가는 입구 주변.
초장	ㅊㅗㅈㅏㅇ	장이 서기 시작한 무렵. 또는 막 서기 시작한 장.
초점	ㅊㅗㅈㅓㅁ	사람들의 관심이 집중되는 대상이나 문제점.
초정	ㅊㅗㅈㅓㅇ	새로 자리에 오른 임금이나 새로 근무지에 도착한 지방의 관리가 일을 시작하던 일.
초진	ㅊㅗㅈㅣㄴ	처음으로 진찰을 함. 또는 그 진찰.
초청	ㅊㅗㅊㅓㅇ	어떤 사람을 손님으로 부름.
초침	ㅊㅗㅊㅣㅁ	시계에서 초를 가리키는 바늘.
초탈	ㅊㅗㅌㅏㄹ	이 세상의 평범한 것이나 능력의 한계를 벗어남.
초판	ㅊㅗㅍㅏㄴ	어떤 일이나 운동 경기 등에서 처음의 시기나 상황.
초혼	ㅊㅗㅎㅗㄴ	처음으로 하는 결혼.
촉구	ㅊㅗㄱㄱㅜ	어떤 일을 급하게 빨리하도록 청함.
촉수	ㅊㅗㄱㅅㅜ	빛의 밝기나 세기의 정도를 나타내는 수.
촌가	ㅊㅗㄴㄱㅏ	시골 마을에 있는 집.
촌로	ㅊㅗㄴㄹㅗ	시골에 사는 나이 많은 사람.
촌부	ㅊㅗㄴㅂㅜ	시골에 사는 남자.
촌수	ㅊㅗㄴㅅㅜ	친척 사이의 멀고 가까운 정도를 나타내는 수. 또는 그런 관계.
촌지	ㅊㅗㄴㅈㅣ	주로 선생님이나 기자, 공무원 등에게 정성을 드러내기 위해 몰래 주는 돈.
촌티	ㅊㅗㄴㅌㅣ	세련되지 못하고 어수룩한 모습이나 태도.
총구	ㅊㅗㅇㄱㅜ	총에서 총알이 나가는 구멍.
총기	ㅊㅗㅇㄱㅣ	권총, 기관총, 소총, 엽총 등의 무기.
총리	ㅊㅗㅇㄹㅣ	대통령을 보좌하고 국가적인 사무를 총괄하는, 장관들의 우두머리가 되는 공무원.
총무	ㅊㅗㅇㅁㅜ	어떤 기관이나 단체의 전체적이며 일반적인 사무. 또는 그 사무를 맡아보는 사람.
총서	ㅊㅗㅇㅅㅓ	일정한 제목, 형식으로 계속해서 출판되어 한 묶음을 이루는 책들.
총수	ㅊㅗㅇㅅㅜ	전체의 수량을 나타낸 수.
총아	ㅊㅗㅇㅇㅏ	특별히 많은 사랑을 받는 사람.
최고	ㅊㅗㅣㄱㅗ	가장 오래됨.
최다	ㅊㅗㅣㄷㅏ	수나 양 등이 가장 많음.
최소	ㅊㅗㅣㅅㅗ	수나 정도가 가장 작거나 낮음.
최저	ㅊㅗㅣㅈㅓ	정도나 수준이 가장 낮음.
최초	ㅊㅗㅣㅊㅗ	맨 처음.
최하	ㅊㅗㅣㅎㅏ	수준이나 등급 등의 맨 아래.
최후	ㅊㅗㅣㅎㅜ	맨 마지막.
추격	ㅊㅜㄱㅕㄱ	앞선 쪽을 잡거나 넘어서려고 공격적으로 뒤쫓아 감.
추계	ㅊㅜㄱㅕㅣ	계절이 가을인 때.
추곡	ㅊㅜㄱㅗㄱ	가을에 거두는 곡식.
추궁	ㅊㅜㄱㅜㅇ	잘못한 일을 샅샅이 따져서 밝힘.
추남	ㅊㅜㄴㅏㅁ	얼굴이 못생긴 남자.
추념	ㅊㅜㄴㅕㅁ	지난 일을 생각함.
추대	ㅊㅜㄷㅏㅣ	윗사람으로 떠받듦.
추돌	ㅊㅜㄷㅗㄹ	자동차나 기차가 뒤에서 들이받음.
추락	ㅊㅜㄹㅏㄱ	높은 곳에서 떨어짐.
추렴	ㅊㅜㄹㅕㅁ	모임이나 놀이, 잔치 등의 비용으로 여러 사람에게 얼마씩의 돈을 거둠.
추론	ㅊㅜㄹㅗㄴ	미루어 생각하여 옳고 그름을 따짐.
추문	ㅊㅜㅁㅜㄴ	지저분하고 잡스러운 소문.
추방	ㅊㅜㅂㅏㅇ	해가 된다고 여겨 일정한 조직이나 지역 또는 나라 밖으로 쫓아냄.
추분	ㅊㅜㅂㅜㄴ	낮과 밤의 길이가 같다는 가을날로 이십사절기의 하나. 9월 23일경이다.
추산	ㅊㅜㅅㅏㄴ	짐작으로 미루어 계산함.
추상	ㅊㅜㅅㅏㅇ	여러 가지 사물이나 개념에서 공통되는 특성이나 속성 등을 뽑아내어 파악하는 것.
추석	ㅊㅜㅅㅓㄱ	한국의 명절의 하나. 음력 8월 15일로 햅쌀로 빚은 송편과 햇과일 등의 음식을 장만하여 차례를 지낸다. 또한 씨름, 줄다리기, 강강술래 등의 민속놀이를 즐긴다.
추세	ㅊㅜㅅㅓㅣ	어떤 일이나 현상이 일정한 방향으로 나아가는 경향.
추신	ㅊㅜㅅㅣㄴ	다 쓴 편지글 아래에 덧붙여 쓰는 말.
추악	ㅊㅜㅇㅏㄱ	더럽고 악함.
추앙	ㅊㅜㅇㅏㅇ	높이 받들어 존경함.
추억	ㅊㅜㅇㅓㄱ	지나간 일을 생각함. 또는 그런 생각이나 일.
추위	ㅊㅜㅇㅜㅣ	주로 겨울철의 추운 기운이나 추운 날씨.
추장	ㅊㅜㅈㅏㅇ	원시 사회에서 부족이나 마을을 이끌고 책임지는 사람.
추적	ㅊㅜㅈㅓㄱ	도망하는 사람을 따라가며 쫓음.
추정	ㅊㅜㅈㅓㅇ	미루어 생각하여 판단하고 정함.
추종	ㅊㅜㅈㅗㅇ	남의 뒤를 따라감.
추진	ㅊㅜㅈㅣㄴ	물체를 밀어 앞으로 나아가게 함.
추징	ㅊㅜㅈㅣㅇ	부족한 것을 나중에 더 거둠.
추천	ㅊㅜㅊㅓㄴ	어떤 조건에 알맞은 사람이나 물건을 책임지고 소개함.
추첨	ㅊㅜㅊㅓㅁ	제비를 뽑음.
추출	ㅊㅜㅊㅜㄹ	전체를 이루는 것 가운데 어떤 요소나 대상을 뽑아냄.
추측	ㅊㅜㅊㅡㄱ	어떤 사실이나 보이는 것을 통해서 다른 무엇을 미루어 짐작함.
추태	ㅊㅜㅌㅏㅣ	더럽고 지저분한 태도나 행동.
축가	ㅊㅜㄱㄱㅏ	축하하기 위해 부르는 노래.
축구	ㅊㅜㄱㄱㅜ	(낮잡아 이르는 말로) 바보 같은 짓을 하는 사람.
축도	ㅊㅜㄱㄷㅗ	기독교에서, 예배를 마칠 때 목사가 다른 사람을 위해 하나님께 복을 비는 기도.
축사	ㅊㅜㄱㅅㅏ	가축을 안에 두고 기르는 건물.
축소	ㅊㅜㄱㅅㅗ	수량, 부피, 규모 등을 줄여서 작게 함.
축수	ㅊㅜㄱㅅㅜ	오래 살게 해 달라고 빎.
축조	ㅊㅜㄱㅈㅗ	돌이나 흙 등을 쌓아 집이나 건물, 성 등을 만듦.
축포	ㅊㅜㄱㅍㅗ	축하하기 위해 소리만 나도록 쏘는 총이나 대포.
축하	ㅊㅜㄱㅎㅏ	남의 좋은 일에 대하여 기쁜 마음으로 인사함. 또는 그런 인사.
춘추	ㅊㅜㄴㅊㅜ	봄과 가을.
출가	ㅊㅜㄹㄱㅏ	집을 떠남.
출고	ㅊㅜㄹㄱㅗ	창고에서 물품을 꺼냄.
출구	ㅊㅜㄹㄱㅜ	밖으로 나갈 수 있는 문이나 통로.
출두	ㅊㅜㄹㄷㅜ	조사 등을 받기 위해 경찰서나 법원 등에 직접 나감.
출마	ㅊㅜㄹㅁㅏ	선거에 나감.
출소	ㅊㅜㄹㅅㅗ	형벌을 받는 기간을 마치고 교도소에서 석방되어 나옴.
출시	ㅊㅜㄹㅅㅣ	상품이 시중에 나옴. 또는 상품을 시중에 내보냄.
출어	ㅊㅜㄹㅇㅓ	고기잡이배가 물고기를 잡으러 나감.
출자	ㅊㅜㄹㅈㅏ	사업 등에 필요한 돈을 내는 일.
출처	ㅊㅜㄹㅊㅓ	말이나 사물이 생기거나 나온 곳.
출타	ㅊㅜㄹㅌㅏ	집에 있지 않고 다른 곳으로 나감.
출토	ㅊㅜㄹㅌㅗ	땅속에 묻혀 있던 오래된 물건이 밖으로 나옴. 또는 그것을 파냄.
출하	ㅊㅜㄹㅎㅏ	짐이나 상품 등을 내보냄.
충고	ㅊㅜㅇㄱㅗ	남의 허물이나 잘못을 진심으로 타이름. 또는 그런 말.
충치	ㅊㅜㅇㅊㅣ	세균이 갉아 먹어 이가 상하는 병. 또는 그 이.
충효	ㅊㅜㅇㅎㅛ	나라에 대한 충성과 부모에 대한 효도.
취기	ㅊㅜㅣㄱㅣ	비위를 상하게 하는 좋지 않은 냄새.
취미	ㅊㅜㅣㅁㅣ	좋아하여 재미로 즐겨서 하는 일.
취사	ㅊㅜㅣㅅㅏ	쓸 만한 것은 쓰고 버릴 것은 버림.
취소	ㅊㅜㅣㅅㅗ	이미 발표한 것을 거두어들이거나 약속한 것 또는 예정된 일을 없앰.
취조	ㅊㅜㅣㅈㅗ	범죄 사실을 밝히기 위해 범행이 의심되는 사람이나 죄인을 조사함.
취지	ㅊㅜㅣㅈㅣ	어떤 일의 근본이 되는 목적이나 매우 중요한 뜻.
취하	ㅊㅜㅣㅎㅏ	신청했던 일이나 서류 등을 취소함.
층수	ㅊㅡㅇㅅㅜ	층의 개수.
치골	ㅊㅣㄱㅗㄹ	몸통과 다리를 연결하는 한 쌍의 큰 뼈의 앞과 아래쪽을 이루는 부분.
치과	ㅊㅣㄱㅗㅏ	이와 더불어 잇몸 등의 지지 조직, 구강 등의 질병을 치료하는 의학 분야. 또는 그 분야의 병원.
치매	ㅊㅣㅁㅏㅣ	주로 노인에게 나타나며, 뇌세포가 손상되어 지능, 의지, 기억 등이 사라지는 병.
치석	ㅊㅣㅅㅓㄱ	이의 겉면에 엉겨 붙어서 굳은 물질.
치실	ㅊㅣㅅㅣㄹ	이 사이에 낀 찌꺼기를 빼내는 데 쓰는 실.
치안	ㅊㅣㅇㅏㄴ	사회의 안전과 질서를 유지함.
치약	ㅊㅣㅇㅑㄱ	이를 닦는 데 쓰는 약.
치열	ㅊㅣㅇㅕㄹ	이가 줄지어 박혀 있는 모양.
치욕	ㅊㅣㅇㅛㄱ	욕되고 창피스러움.
치읓	ㅊㅣㅇㅡㅊ	한글 자모 ‘ㅊ’의 이름.
치장	ㅊㅣㅈㅏㅇ	잘 매만져 곱게 꾸밈.
치적	ㅊㅣㅈㅓㄱ	잘 다스리거나 정치를 잘해서 쌓은 업적.
치정	ㅊㅣㅈㅓㅇ	남녀 간의 사랑으로 생기는 여러 가지 어지러운 정.
치중	ㅊㅣㅈㅜㅇ	어떠한 것을 특히 중요하게 여김.
치질	ㅊㅣㅈㅣㄹ	항문 안이나 바깥에 생기는 질병.
치킨	ㅊㅣㅋㅣㄴ	토막을 낸 닭에 밀가루 등을 묻혀 기름에 튀기거나 구운 음식.
치통	ㅊㅣㅌㅗㅇ	이가 쑤시거나 몹시 아픈 것.
치한	ㅊㅣㅎㅏㄴ	여자에게 성적으로 치근대거나 나쁜 짓을 하며 괴롭히는 남자.
친가	ㅊㅣㄴㄱㅏ	아버지 쪽 집안.
친교	ㅊㅣㄴㄱㅛ	친하고 가깝게 사귐. 또는 그렇게 사귄 정.
친구	ㅊㅣㄴㄱㅜ	사이가 가까워 서로 친하게 지내는 사람.
친모	ㅊㅣㄴㅁㅗ	자기를 낳아 준 어머니.
친부	ㅊㅣㄴㅂㅜ	자기를 낳아 준 아버지.
친서	ㅊㅣㄴㅅㅓ	직접 쓴 편지.
친자	ㅊㅣㄴㅈㅏ	자기가 낳은 자식.
친지	ㅊㅣㄴㅈㅣ	서로 친하여 가깝게 지내는 사람.
칠기	ㅊㅣㄹㄱㅣ	옻나무에서 나는 검붉은 진을 칠해 윤이 나게 한 그릇이나 물건.
침구	ㅊㅣㅁㄱㅜ	이부자리나 베개 등과 같이 잠을 잘 때 쓰는 것.
침수	ㅊㅣㅁㅅㅜ	물에 잠김.
침투	ㅊㅣㅁㅌㅜ	물이나 비 등의 액체가 스며들어 뱀.
칩거	ㅊㅣㅂㄱㅓ	밖에 나가서 활동하지 않고 집 안에만 틀어박혀 있음.
칭호	ㅊㅣㅇㅎㅗ	어떠한 뜻으로 부르거나 말하는 이름.
카레	ㅋㅏㄹㅓㅣ	강황, 생강, 후추, 마늘 등을 섞어 만든 노란 빛깔의 향신료.
카페	ㅋㅏㅍㅓㅣ	주로 커피와 차, 가벼운 간식거리 등을 파는 가게.
카폰	ㅋㅏㅍㅗㄴ	자동차 안에 설치하여 운전 중에도 통화할 수 있는 무선 전화.
칼라	ㅋㅏㄹㄹㅏ	양복이나 셔츠 등의 목둘레에 길게 덧붙여진 천.
커닝	ㅋㅓㄴㅣㅇ	시험을 볼 때, 미리 준비해 온 답이나 남의 답안지를 몰래 보고 답을 쓰는 일.
커튼	ㅋㅓㅌㅡㄴ	창이나 문을 가릴 수 있도록 그 위에 매달아 길게 늘어뜨린 천.
커플	ㅋㅓㅍㅡㄹ	짝이 되는 남녀 한 쌍.
컬러	ㅋㅓㄹㄹㅓ	분명한 빛깔.
케냐	ㅋㅓㅣㄴㅑ	아프리카 동부 적도 아래에 있는 나라. 세계 야생 동물의 보고로 야생 동물 보호 지구가 있으며 주로 커피 등의 농업이나 관광 산업이 발달해 있다. 주요 언어는 영어와 스와힐리어이고 수도는 나이로비이다.
코냑	ㅋㅗㄴㅑㄱ	포도주를 증류하여 만든 고급 술.
코란	ㅋㅗㄹㅏㄴ	이슬람교의 이치와 가르침을 적은 책.
코밑	ㅋㅗㅁㅣㅌ	코의 아랫부분이란 뜻으로, 아주 가까운 곳.
코뼈	ㅋㅗㅂㅂㅕ	콧등의 윗부분을 이루는 얇고 길쭉한 한 쌍의 뼈.
코앞	ㅋㅗㅇㅏㅍ	코의 바로 앞이란 뜻으로, 아주 가까운 곳.
코털	ㅋㅗㅌㅓㄹ	콧구멍 속에 난 털.
코팅	ㅋㅗㅌㅣㅇ	물체의 겉면을 엷은 막으로 입히는 일.
콘도	ㅋㅗㄴㄷㅗ	객실에 취사 도구를 비롯한 기본적인 살림살이를 갖추고 있으며, 객실 단위로 분양하여 운영하는 형태의 호텔.
콜라	ㅋㅗㄹㄹㅏ	맛이 달고 독특한 향이 나는 검은색의 탄산음료.
콤비	ㅋㅗㅁㅂㅣ	어떤 일을 하기 위해 두 사람이 짝을 이루는 것. 또는 그 두 사람.
콩트	ㅋㅗㅇㅌㅡ	단편 소설보다도 더 짧고 재치 있게 쓴 소설.
쿠션	ㅋㅜㅅㅕㄴ	앉을 자리에 솜이나 용수철 등을 넣어 편하게 앉도록 만든 것.
쿠폰	ㅋㅜㅍㅗㄴ	한 장씩 떼어 돈처럼 사용하는 표.
쿼터	ㅋㅜㅓㅌㅓ	어떤 것을 여럿이 나누어 가질 때 각자 가지게 되는 부분.
퀴즈	ㅋㅜㅣㅈㅡ	질문에 대한 답을 알아맞히는 놀이. 또는 그 질문.
크림	ㅋㅡㄹㅣㅁ	버터, 아이스크림 등의 원료나 조리에 사용하는, 우유에서 얻는 하얀 기름.
큰비	ㅋㅡㄴㅂㅣ	오랫동안 많이 쏟아지는 비.
키위	ㅋㅣㅇㅜㅣ	달걀 모양에 갈색 털이 덮여 있으며, 속 한가운데 부분은 옅은 노란색이고 그 둘레는 옅은 녹색이며 깨알 같은 씨가 박혀 있는 과일.
키읔	ㅋㅣㅇㅡㅋ	한글 자모 ‘ㅋ’의 이름.
타개	ㅌㅏㄱㅏㅣ	어려운 일을 잘 처리하여 해결의 길을 엶.
타격	ㅌㅏㄱㅕㄱ	때려 침.
타결	ㅌㅏㄱㅕㄹ	의견이 서로 다른 사람이나 단체가 서로 양보하여 일을 끝맺음.
타계	ㅌㅏㄱㅕㅣ	다른 세계.
타국	ㅌㅏㄱㅜㄱ	자기 나라가 아닌 다른 나라.
타락	ㅌㅏㄹㅏㄱ	올바른 길에서 벗어나 나쁜 길로 빠짐.
타래	ㅌㅏㄹㅏㅣ	동그랗게 감아서 뭉쳐 놓은 실이나 노끈 등의 뭉치.
타령	ㅌㅏㄹㅕㅇ	어떤 말이나 소리를 자꾸 되풀이하는 일.
타박	ㅌㅏㅂㅏㄱ	다른 사람의 실수나 결함을 나무라거나 핀잔함.
타살	ㅌㅏㅅㅏㄹ	남을 죽임.
타석	ㅌㅏㅅㅓㄱ	야구에서, 투수가 던지는 공을 타자가 치도록 정해 놓은 구역.
타선	ㅌㅏㅅㅓㄴ	야구에서, 공을 치는 능력 면에서 본 타자들의 구성.
타성	ㅌㅏㅅㅓㅇ	오랫동안 변화가 없어 버릇처럼 굳어진 행동이나 습성.
타워	ㅌㅏㅇㅜㅓ	탑처럼 뾰족하고 높게 만든 건축물.
타율	ㅌㅏㅇㅠㄹ	자신의 의지와 상관없이 정해진 규칙이나 다른 사람의 명령에 따라 행동하는 일.
타의	ㅌㅏㅇㅡㅣ	다른 생각이나 마음.
타인	ㅌㅏㅇㅣㄴ	다른 사람.
타일	ㅌㅏㅇㅣㄹ	바닥이나 벽에 붙이는, 점토를 구워서 만든 작은 도자기 판.
타임	ㅌㅏㅇㅣㅁ	수영이나 육상 등에서, 정한 거리를 가는 데에 걸리는 시간.
타입	ㅌㅏㅇㅣㅂ	성질이나 특징, 모양 등이 비슷한 것끼리 묶은 하나의 무리. 또는 그 무리에 속하는 것.
타작	ㅌㅏㅈㅏㄱ	곡식을 떨어서 낟알을 거두는 일.
타점	ㅌㅏㅈㅓㅁ	야구에서, 타자가 안타 등을 쳐서 얻은 점수.
타종	ㅌㅏㅈㅗㅇ	종을 치거나 때림.
타향	ㅌㅏㅎㅑㅇ	자기 고향이 아닌 다른 고장.
타협	ㅌㅏㅎㅕㅂ	어떤 일을 서로 양보하여 의논함.
탁구	ㅌㅏㄱㄱㅜ	네모난 테이블 가운데에 네트를 세우고, 공을 라켓으로 쳐서 넘기고 받는 실내 경기.
탁류	ㅌㅏㄱㄹㅠ	흘러가는 흐린 물.
탁아	ㅌㅏㄱㅇㅏ	보호자 대신 어린아이를 맡아 돌보는 일.
탁자	ㅌㅏㄱㅈㅏ	떠받치는 다리가 있고 위가 평평해서 물건을 올려놓을 수 있는 책상 모양의 가구.
탁주	ㅌㅏㄱㅈㅜ	맛이 약간 텁텁하며 쌀로 만든 한국 고유의 하얀색 술.
탄도	ㅌㅏㄴㄷㅗ	쏘아진 탄알이나 미사일이 목표에 이를 때까지 그리는 선.
탄로	ㅌㅏㄴㄹㅗ	숨긴 일을 드러냄.
탄소	ㅌㅏㄴㅅㅗ	숯이나 석탄의 주된 구성 원소.
탄피	ㅌㅏㄴㅍㅣ	탄환이나 포탄의 껍데기.
탈고	ㅌㅏㄹㄱㅗ	원고 쓰기를 마침.
탈구	ㅌㅏㄹㄱㅜ	뼈나 관절이 삐어 제자리에서 벗어남.
탈루	ㅌㅏㄹㄹㅜ	밖으로 빼내 다른 데로 나가게 함.
탈모	ㅌㅏㄹㅁㅗ	털이나 머리카락 등이 빠짐.
탈수	ㅌㅏㄹㅅㅜ	물체 안에 들어 있는 물기를 뺌. 또는 물기가 빠짐.
탈피	ㅌㅏㄹㅍㅣ	어떤 처지나 상태에서 완전히 벗어남.
탐구	ㅌㅏㅁㄱㅜ	학문 등을 깊이 파고들어 연구함.
탐미	ㅌㅏㅁㅁㅣ	아름다움을 지나치게 추구하여 거기에 빠짐.
탐사	ㅌㅏㅁㅅㅏ	알려지지 않은 사물이나 사실을 빠짐없이 조사함.
탐지	ㅌㅏㅁㅈㅣ	드러나지 않은 사실이나 물건을 이리저리 찾아 알아냄.
탕아	ㅌㅏㅇㅇㅏ	술, 여자, 도박 등에 빠져 행실이 좋지 못한 사내.
태고	ㅌㅏㅣㄱㅗ	아주 먼 옛날.
태교	ㅌㅏㅣㄱㅛ	아이를 가진 여자가 태아에게 좋은 영향을 주기 위해 마음을 바르게 하고 말을 조심하는 일.
태기	ㅌㅏㅣㄱㅣ	배 속에 아이를 가진 느낌.
태도	ㅌㅏㅣㄷㅗ	몸을 움직이거나 어떤 일을 대하는 마음이 드러난 자세.
태두	ㅌㅏㅣㄷㅜ	(비유적으로) 어떤 분야에서 가장 권위가 있는 사람.
태아	ㅌㅏㅣㅇㅏ	어머니 배 속에서 자라고 있는 아이.
태자	ㅌㅏㅣㅈㅏ	임금의 자리를 이을 임금의 아들.
태초	ㅌㅏㅣㅊㅗ	하늘과 땅이 생긴 맨 처음.
터널	ㅌㅓㄴㅓㄹ	산, 바다, 강 등의 밑을 뚫어서 기차나 자동차가 지나다닐 수 있게 만든 통로.
터득	ㅌㅓㄷㅡㄱ	깊이 생각하여 스스로 이치를 깨달아 알아냄.
터럭	ㅌㅓㄹㅓㄱ	사람이나 짐승의 몸에 난 길고 굵은 털.
터울	ㅌㅓㅇㅜㄹ	한 어머니가 낳은 자녀들의 나이 차이. 또는 먼저 아이를 낳은 때로부터 다음 아이를 낳은 때까지의 사이.
터전	ㅌㅓㅈㅓㄴ	집터가 되는 땅.
털보	ㅌㅓㄹㅂㅗ	(낮잡아 이르는 말로) 몸에 털이나 수염이 많은 사람.
테너	ㅌㅓㅣㄴㅓ	성악에서 남성의 가장 높은 목소리. 또는 그 목소리로 노래하는 가수.
테러	ㅌㅓㅣㄹㅓ	폭력을 사용하여 상대를 해치거나 공포를 느끼게 하는 행위.
테마	ㅌㅓㅣㅁㅏ	창작이나 논의의 중심 내용이나 주제.
토건	ㅌㅗㄱㅓㄴ	토목과 건축.
토굴	ㅌㅗㄱㅜㄹ	땅을 깊고 길게 파서 굴과 같이 만든 큰 구덩이.
토끼	ㅌㅗㄱㄱㅣ	귀가 길고 뒷다리가 앞다리보다 발달하였으며 꼬리는 짧은 동물.
토담	ㅌㅗㄷㅏㅁ	흙으로 쌓아 만든 담.
토대	ㅌㅗㄷㅏㅣ	건물을 지탱하는, 건물의 제일 밑부분.
토란	ㅌㅗㄹㅏㄴ	높이는 80~120센티미터이고 잎은 두껍고 넓은 방패 모양이며 땅속의 알 모양 줄기를 먹는 식물.
토론	ㅌㅗㄹㅗㄴ	어떤 문제에 대하여 여러 사람이 옳고 그름을 따지며 논의함.
토막	ㅌㅗㅁㅏㄱ	좀 크게 덩어리가 진 도막.
토목	ㅌㅗㅁㅗㄱ	흙과 나무.
토방	ㅌㅗㅂㅏㅇ	방에 들어가는 문 앞에 약간 높고 편평하게 다진 흙바닥.
토벌	ㅌㅗㅂㅓㄹ	무력으로 쳐서 없앰.
토성	ㅌㅗㅅㅓㅇ	태양에서 여섯째로 가까운 행성.
토속	ㅌㅗㅅㅗㄱ	그 지방에만 있는 특별한 관습이나 풍속.
토양	ㅌㅗㅇㅑㅇ	지구의 표면을 덮고 있는, 작은 알갱이로 이루어진 물질.
토의	ㅌㅗㅇㅡㅣ	여러 사람이 어떤 문제에 대해 자세히 따지고 의논함.
토종	ㅌㅗㅈㅗㅇ	원래부터 그곳에서 나는 종자.
토질	ㅌㅗㅈㅣㄹ	흙의 성질.
토착	ㅌㅗㅊㅏㄱ	대대로 그곳에서 태어나서 살고 있음. 또는 그곳에 들어와서 정착함.
토큰	ㅌㅗㅋㅡㄴ	(옛날에) 버스 요금을 낼 때 돈 대신에 내는 동전 모양의 물건.
토플	ㅌㅗㅍㅡㄹ	영어를 공용어로 사용하고 있는 나라에 유학을 가려는 사람을 대상으로 하는 영어 시험.
토픽	ㅌㅗㅍㅣㄱ	이야기의 제목.
토핑	ㅌㅗㅍㅣㅇ	요리의 마무리 단계에서, 거의 완성된 요리에 재료를 올리거나 장식을 하는 것.
톱니	ㅌㅗㅂㄴㅣ	톱의 가장자리에 있는 뾰족뾰족한 부분.
통고	ㅌㅗㅇㄱㅗ	어떤 사실이나 소식을 글이나 말로 전하여 알림.
통기	ㅌㅗㅇㄱㅣ	공기가 통함. 또는 공기가 통하게 함.
통로	ㅌㅗㅇㄹㅗ	지나다닐 수 있게 낸 길.
통보	ㅌㅗㅇㅂㅗ	어떤 명령이나 소식 등을 말이나 글로 알림.
통사	ㅌㅗㅇㅅㅏ	모든 시대와 모든 지역에 걸쳐 역사의 줄거리를 서술하는 역사 기술의 양식. 또는 그렇게 서술한 역사.
통지	ㅌㅗㅇㅈㅣ	어떤 사실을 알림.
통치	ㅌㅗㅇㅊㅣ	나라나 지역을 맡아 다스림.
퇴거	ㅌㅗㅣㄱㅓ	있던 자리에서 물러나거나 떠남.
퇴고	ㅌㅗㅣㄱㅗ	글을 쓸 때 여러 번 고치고 다듬음. 또는 그런 일.
퇴로	ㅌㅗㅣㄹㅗ	뒤로 물러날 길.
퇴보	ㅌㅗㅣㅂㅗ	뒤로 물러감.
퇴비	ㅌㅗㅣㅂㅣ	풀, 짚 또는 가축의 똥과 오줌 등을 썩힌 거름.
퇴사	ㅌㅗㅣㅅㅏ	회사에서 일을 끝내고 집으로 감.
퇴조	ㅌㅗㅣㅈㅗ	기운, 세력 등이 줄어듦.
퇴치	ㅌㅗㅣㅊㅣ	물리쳐서 없애 버림.
투계	ㅌㅜㄱㅕㅣ	닭을 싸우게 하여 승부를 겨룸. 또는 그런 놀이.
투과	ㅌㅜㄱㅗㅏ	빛, 액체, 소리 등이 물질을 뚫고 통과함.
투망	ㅌㅜㅁㅏㅇ	물고기를 잡으려고 그물을 물속에 던져 침.
투매	ㅌㅜㅁㅏㅣ	손해를 무릅쓰고 주식이나 채권을 싼값에 팔아 버리는 일.
투명	ㅌㅜㅁㅕㅇ	물이나 유리 등이 맑음.
투병	ㅌㅜㅂㅕㅇ	병을 고치려는 의지를 가지고 병과 싸움.
투석	ㅌㅜㅅㅓㄱ	돌을 던짐. 또는 그 돌.
투숙	ㅌㅜㅅㅜㄱ	여관, 호텔 등의 숙박 시설에서 묵음.
투신	ㅌㅜㅅㅣㄴ	어떤 일이나 직업, 분야 등에 온갖 정열을 다해 마음을 쏟음.
투약	ㅌㅜㅇㅑㄱ	약을 지어 주거나 주사로 놓음.
투영	ㅌㅜㅇㅕㅇ	물체의 그림자를 어떤 물체 위에 비추는 일. 또는 그 비친 그림자.
투옥	ㅌㅜㅇㅗㄱ	감옥에 가둠.
투입	ㅌㅜㅇㅣㅂ	던져 넣음.
투정	ㅌㅜㅈㅓㅇ	무엇이 모자라거나 마음에 들지 않아 떼를 쓰며 조르는 일.
투척	ㅌㅜㅊㅓㄱ	물건 등을 던짐.
투항	ㅌㅜㅎㅏㅇ	적에게 항복함.
투혼	ㅌㅜㅎㅗㄴ	끝까지 싸우려는 씩씩한 정신.
퉁소	ㅌㅜㅇㅅㅗ	대나무로 만들었고 앞에는 다섯 개, 뒤에는 한 개의 구멍이 있으며 세로로 내려 부는 악기.
튀기	ㅌㅜㅣㄱㅣ	종이 다른 두 동물 사이에서 태어난 동물.
트럭	ㅌㅡㄹㅓㄱ	물건을 실어 나르는 자동차.
트림	ㅌㅡㄹㅣㅁ	먹은 음식이 잘 소화되지 않아서 생긴 가스가 입으로 나옴. 또는 그 가스.
트집	ㅌㅡㅈㅣㅂ	아무 이유 없이 작은 흠을 들추어내어 불평을 하거나 말썽을 부림. 또는 그 불평이나 말썽.
특기	ㅌㅡㄱㄱㅣ	남이 가지지 못한 특별한 기술이나 재능.
특무	ㅌㅡㄱㅁㅜ	보통과 다르게 특별히 맡거나 맡겨진 일.
특보	ㅌㅡㄱㅂㅗ	특별히 대중 매체를 통하여 새로운 소식을 알림. 또는 그 소식.
특사	ㅌㅡㄱㅅㅏ	특별한 임무를 받아 외국으로 보내지는 사람.
특수	ㅌㅡㄱㅅㅜ	보통과 매우 차이가 나게 다름.
특유	ㅌㅡㄱㅇㅠ	일정한 사람이나 사물만이 특별히 갖추고 있음.
특이	ㅌㅡㄱㅇㅣ	보통의 것에 비해 뚜렷하게 다름.
특파	ㅌㅡㄱㅍㅏ	특별한 임무를 주어 사람을 보냄.
특허	ㅌㅡㄱㅎㅓ	특정한 사람에게 일정한 권리나 능력을 주는 행정 행위.
특효	ㅌㅡㄱㅎㅛ	어떤 병이나 증세에 특별히 좋은 효과.
틀니	ㅌㅡㄹㄴㅣ	잇몸에 끼웠다 뺐다 할 수 있게 인공적으로 만든 이.
티눈	ㅌㅣㄴㅜㄴ	손이나 발에 동그랗고 볼록하게 돋은 굳은살.
티읕	ㅌㅣㅇㅡㅌ	한글 자모 ‘ㅌ’의 이름.
파격	ㅍㅏㄱㅕㄱ	일정한 격식을 깨뜨림. 또는 그 격식.
파견	ㅍㅏㄱㅕㄴ	일정한 임무를 주어 사람을 보냄.
파경	ㅍㅏㄱㅕㅇ	(비유적으로) 사이가 나빠서 부부가 헤어짐.
파계	ㅍㅏㄱㅕㅣ	불교의 계율을 지키지 않고 어김.
파괴	ㅍㅏㄱㅗㅣ	때려 부수거나 깨뜨려 무너뜨림.
파국	ㅍㅏㄱㅜㄱ	일이나 사태가 잘못되어 망가져 버림. 또는 그 판국.
파급	ㅍㅏㄱㅡㅂ	어떤 일의 영향이 차차 다른 데로 퍼져 미침.
파동	ㅍㅏㄷㅗㅇ	물결의 움직임.
파란	ㅍㅏㄹㅏㄴ	크고 작은 물결.
파랑	ㅍㅏㄹㅏㅇ	파란 빛깔이나 물감.
파래	ㅍㅏㄹㅏㅣ	사람이 먹을 수 있는, 바다에서 나는 가늘고 긴 녹색의 식물.
파면	ㅍㅏㅁㅕㄴ	잘못을 한 사람에게 일이나 직장을 그만두게 함.
파멸	ㅍㅏㅁㅕㄹ	파괴되어 완전히 없어지거나 망함.
파문	ㅍㅏㅁㅜㄴ	수면에 생긴 물결.
파벌	ㅍㅏㅂㅓㄹ	이익과 손해에 따라 갈라진 사람들의 집단.
파병	ㅍㅏㅂㅕㅇ	군대를 보냄.
파산	ㅍㅏㅅㅏㄴ	재산을 모두 잃고 망함.
파상	ㅍㅏㅅㅏㅇ	물결의 모양.
파선	ㅍㅏㅅㅓㄴ	거센 바람이나 파도를 만나거나, 바위나 빙산 등에 부딪쳐 배가 부서짐. 또는 그 배.
파손	ㅍㅏㅅㅗㄴ	깨어져 못 쓰게 됨. 또는 깨뜨려 못 쓰게 함.
파송	ㅍㅏㅅㅗㅇ	임무를 주어 사람을 어떤 곳에 보냄.
파악	ㅍㅏㅇㅏㄱ	어떤 일이나 대상의 내용이나 상황을 확실하게 이해하여 앎.
파업	ㅍㅏㅇㅓㅂ	하던 일을 도중에 그만둠.
파열	ㅍㅏㅇㅕㄹ	깨지거나 갈라져 터짐.
파울	ㅍㅏㅇㅜㄹ	경기의 규칙을 어기는 일.
파워	ㅍㅏㅇㅜㅓ	다른 사람을 지배할 수 있는 힘이나 권력.
파일	ㅍㅏㅇㅣㄹ	서류들을 한데 모아 매어 두게 만든 도구. 또는 그렇게 매어 둔 서류 묶음.
파장	ㅍㅏㅈㅏㅇ	전파나 음파의 파동에서, 같은 위상을 가진 서로 이웃한 두 점 사이의 거리.
파전	ㅍㅏㅈㅓㄴ	반죽한 밀가루에 길쭉하게 썬 파와 해산물 등을 넣어 지진 음식.
파종	ㅍㅏㅈㅗㅇ	논밭에 곡식이나 채소의 씨를 뿌림.
파직	ㅍㅏㅈㅣㄱ	공무원이나 관리의 지위에서 물러나게 함.
파탄	ㅍㅏㅌㅏㄴ	일이나 계획 등이 잘 진행되지 못하고 도중에 잘못됨.
파편	ㅍㅏㅍㅕㄴ	깨지거나 부서진 조각.
파혼	ㅍㅏㅎㅗㄴ	결혼하기로 한 약속을 깸.
판다	ㅍㅏㄴㄷㅏ	몸집이 크고, 주로 머리와 몸통의 털은 흰색이며 눈 주변과 귀, 다리 등의 털은 검은색인 곰.
판도	ㅍㅏㄴㄷㅗ	한 나라의 영토.
판로	ㅍㅏㄴㄹㅗ	상품이 팔리는 길.
판사	ㅍㅏㄴㅅㅏ	대법원을 제외한 법원의 법관.
판서	ㅍㅏㄴㅅㅓ	칠판에 분필로 글을 씀. 또는 그 글.
판자	ㅍㅏㄴㅈㅏ	평평하고 넓게 만든 나뭇조각.
팔도	ㅍㅏㄹㄷㅗ	대한민국의 전체.
팔자	ㅍㅏㄹㅈㅏ	사람이 태어난 해, 달, 날, 시에 따라 정해진다고 보는, 사람의 한 평생의 운수.
패기	ㅍㅏㅣㄱㅣ	어떤 힘겨운 일이라도 해내려는 굳센 정신.
패드	ㅍㅏㅣㄷㅡ	양복의 모양을 알맞게 잡아 주기 위해 어깨에 넣는 심.
패소	ㅍㅏㅣㅅㅗ	재판에서 짐.
패스	ㅍㅏㅣㅅㅡ	시험이나 검사 등에 합격함.
패자	ㅍㅏㅣㅈㅏ	싸움이나 경기에서 진 사람.
퍼즐	ㅍㅓㅈㅡㄹ	풀면서 두뇌 활동이 좋아지고 재미도 얻도록 만든 알아맞히기 놀이.
펀드	ㅍㅓㄴㄷㅡ	투자 전문 기관이 투자자로부터 받은 돈.
펀치	ㅍㅓㄴㅊㅣ	종이나 기차표 등에 구멍을 뚫는 도구.
펌프	ㅍㅓㅁㅍㅡ	압력을 이용해 액체나 기체를 빨아올리거나 이동시키는 기계.
펑크	ㅍㅓㅇㅋㅡ	고무 튜브 등에 구멍이 나서 터지는 일. 또는 그 구멍.
페루	ㅍㅓㅣㄹㅜ	남아메리카 서북부에 있는 나라. 잉카 제국의 중심지로 고대 문화유산을 간직하고 있다. 주민 대부분이 가톨릭교도이며 주요 언어는 에스파냐어이고 수도는 리마이다.
편도	ㅍㅕㄴㄷㅗ	가고 오는 길 가운데 어느 한쪽. 또는 그 길.
편리	ㅍㅕㄴㄹㅣ	이용하기 쉽고 편함.
편모	ㅍㅕㄴㅁㅗ	아버지가 죽거나 이혼하여 홀로 있는 어머니.
편수	ㅍㅕㄴㅅㅜ	비행기나 배, 자동차, 기차 등이 운행하는 수.
편저	ㅍㅕㄴㅈㅓ	편집하여 글이나 책 등을 씀.
편지	ㅍㅕㄴㅈㅣ	다른 사람에게 하고 싶은 말을 적어서 보내는 글.
편파	ㅍㅕㄴㅍㅏ	올바르지 못하고 어느 한쪽으로 치우쳐 있음.
평가	ㅍㅕㅇㄱㅏ	사물의 값이나 가치, 수준 등을 헤아려 정함. 또는 그 값이나 가치, 수준.
평소	ㅍㅕㅇㅅㅗ	특별한 일이 없는 보통 때.
평수	ㅍㅕㅇㅅㅜ	평으로 계산한 넓이나 부피.
평시	ㅍㅕㅇㅅㅣ	특별한 일이 없는 보통 때.
평야	ㅍㅕㅇㅇㅑ	지표면이 평평하고 넓은 들.
평자	ㅍㅕㅇㅈㅏ	글이나 예술 작품 등을 비평하는 사람.
평지	ㅍㅕㅇㅈㅣ	바닥이 평평하고 넓은 땅.
폐가	ㅍㅕㅣㄱㅏ	사람이 살지 않고 버려두어 낡은 집.
폐교	ㅍㅕㅣㄱㅛ	학교 문을 닫고 수업을 그만두고 쉼.
폐기	ㅍㅕㅣㄱㅣ	못 쓰게 된 것을 버림.
폐수	ㅍㅕㅣㅅㅜ	공장이나 광산 등에서 쓰고 난 뒤에 버리는 더러운 물.
폐지	ㅍㅕㅣㅈㅣ	실시해 오던 제도나 법규, 일 등을 그만두거나 없앰.
폐차	ㅍㅕㅣㅊㅏ	낡거나 못 쓰게 된 차를 없앰. 또는 그 차.
폐하	ㅍㅕㅣㅎㅏ	황제나 황후를 높여 부르는 말.
폐허	ㅍㅕㅣㅎㅓ	건물 등이 파괴되어 못 쓰게 된 터.
포격	ㅍㅗㄱㅕㄱ	대포를 쏨.
포경	ㅍㅗㄱㅕㅇ	남자의 성기 끝이 껍질에 싸여 있는 것. 또는 그런 성기.
포대	ㅍㅗㄷㅏㅣ	종이나 가죽, 천 등으로 만든 큰 자루.
포목	ㅍㅗㅁㅗㄱ	베와 무명.
포문	ㅍㅗㅁㅜㄴ	대포의 탄알이 나가는 구멍.
포병	ㅍㅗㅂㅕㅇ	육군에서 대포를 다루는 군대나 군인.
포복	ㅍㅗㅂㅗㄱ	배를 땅에 대고 김.
포볼	ㅍㅗㅂㅗㄹ	야구에서 투수가 타자에게 스트라이크가 아닌 볼을 네 번 던지는 일.
포상	ㅍㅗㅅㅏㅇ	잘한 일을 칭찬하고 앞으로 더 잘하기를 바라며 상을 줌.
포석	ㅍㅗㅅㅓㄱ	바둑에서, 나중에 유리하도록 처음에 바둑돌을 늘어놓는 일.
포섭	ㅍㅗㅅㅓㅂ	적이나 상대편을 자기편으로 끌어들임.
포성	ㅍㅗㅅㅓㅇ	대포를 쏠 때 나는 소리.
포승	ㅍㅗㅅㅡㅇ	죄인을 잡아 묶는 끈.
포식	ㅍㅗㅅㅣㄱ	배부르게 많이 먹음.
포악	ㅍㅗㅇㅏㄱ	성격이나 행동이 사납고 악함.
포옹	ㅍㅗㅇㅗㅇ	사람을 품에 안거나 사람끼리 껴안음.
포용	ㅍㅗㅇㅛㅇ	남을 넓은 마음으로 감싸 주거나 받아들임.
포위	ㅍㅗㅇㅜㅣ	주위를 빙 둘러쌈.
포장	ㅍㅗㅈㅏㅇ	물건을 싸거나 꾸림. 또는 싸거나 꾸리는 데 사용하는 재료.
포진	ㅍㅗㅈㅣㄴ	전쟁이나 경기 등을 하기 위해 군대나 군인, 선수 등을 배치함.
포착	ㅍㅗㅊㅏㄱ	어떤 것을 꼭 붙잡음.
포탄	ㅍㅗㅌㅏㄴ	대포의 탄알.
포탈	ㅍㅗㅌㅏㄹ	내야 하는 세금을 피하여 내지 않음.
포학	ㅍㅗㅎㅏㄱ	성질이나 행동이 몹시 잔인하고 난폭함.
포함	ㅍㅗㅎㅏㅁ	어떤 무리나 범위에 함께 들어 있거나 함께 넣음.
포화	ㅍㅗㅎㅗㅏ	총이나 대포를 쏠 때 일어나는 불.
폭거	ㅍㅗㄱㄱㅓ	몹시 거칠고 사나운 행동.
폭도	ㅍㅗㄱㄷㅗ	폭동을 일으키거나 같은 편이 되어 폭동을 도운 무리.
폭로	ㅍㅗㄱㄹㅗ	알려지지 않았거나 숨겨져 있던 사실을 드러내어 사람들에게 알림.
폭리	ㅍㅗㄱㄹㅣ	옳지 않은 방법을 사용하여 지나치게 많이 남기는 이익.
폭소	ㅍㅗㄱㅅㅗ	갑자기 웃음이 크고 세게 터져 나옴. 또는 그 웃음.
폭우	ㅍㅗㄱㅇㅜ	갑자기 많이 쏟아지는 비.
폭주	ㅍㅗㄱㅈㅜ	아주 빠른 속도로 거칠고 사납게 달림.
폭파	ㅍㅗㄱㅍㅏ	폭발시켜 부숨.
폭포	ㅍㅗㄱㅍㅗ	절벽에서 쏟아져 내리는 세찬 물줄기.
폴더	ㅍㅗㄹㄷㅓ	컴퓨터에서 관련 있는 파일을 묶어서 하나의 아이콘으로 나타낸 것.
표결	ㅍㅛㄱㅕㄹ	투표를 해서 결정함.
표독	ㅍㅛㄷㅗㄱ	사납고 악독함.
표면	ㅍㅛㅁㅕㄴ	사물의 가장 바깥쪽. 또는 가장 윗부분.
표명	ㅍㅛㅁㅕㅇ	생각이나 태도를 분명하게 드러냄.
표방	ㅍㅛㅂㅏㅇ	어떤 이유를 붙여 자신의 주장이나 처지를 앞에 내세움.
표밭	ㅍㅛㅂㅏㅌ	(비유적으로) 투표할 사람이 모여 있는 선거 구역.
표범	ㅍㅛㅂㅓㅁ	호랑이보다 몸집이 조금 작고 온몸에 검고 둥근 무늬가 있으며 재빠르고 사나운 동물.
표본	ㅍㅛㅂㅗㄴ	본보기로 삼을 만한 것.
표상	ㅍㅛㅅㅏㅇ	보고 배워서 본을 받을 만한 대상.
표식	ㅍㅛㅅㅣㄱ	무엇을 나타내 보이는 일정한 방식.
표적	ㅍㅛㅈㅓㄱ	목표로 삼는 물건.
표절	ㅍㅛㅈㅓㄹ	글, 노래 등을 지을 때 다른 사람의 작품의 일부를 몰래 따와서 씀.
표정	ㅍㅛㅈㅓㅇ	마음속에 품은 감정이나 생각 등이 얼굴에 드러남. 또는 그런 모습.
표준	ㅍㅛㅈㅜㄴ	사물의 성격이나 정도 등을 알기 위한 근거나 기준.
표징	ㅍㅛㅈㅣㅇ	겉으로 나타나는 특징이나 상징.
표찰	ㅍㅛㅊㅏㄹ	어떤 것을 다른 것과 구별하기 위해 이름, 숫자 등을 써서 표시해 놓은 것.
표창	ㅍㅛㅊㅏㅇ	뛰어난 성과를 내거나 훌륭한 행동을 한 것을 칭찬함. 또는 칭찬하는 뜻으로 증서나 메달 등을 줌.
표출	ㅍㅛㅊㅜㄹ	겉으로 나타냄.
표현	ㅍㅛㅎㅕㄴ	느낌이나 생각 등을 말, 글, 몸짓 등으로 나타내어 겉으로 드러냄.
푸념	ㅍㅜㄴㅕㅁ	마음속에 있는 불평을 늘어놓음. 또는 그런 말.
푼수	ㅍㅜㄴㅅㅜ	상태나 형편.
풀기	ㅍㅜㄹㄱㅣ	옷이나 천 따위에 밴 풀의 빳빳한 기운.
풀이	ㅍㅜㄹㅇㅣ	모르거나 어려운 것을 알기 쉽게 밝혀 말하는 일.
품사	ㅍㅜㅁㅅㅏ	단어를 기능, 형태, 의미에 따라 나눈 갈래.
풍기	ㅍㅜㅇㄱㅣ	풍속, 습관, 도덕에 관한 규율. 특히 남녀 교제에 있어서의 규율.
풍류	ㅍㅜㅇㄹㅠ	멋스럽게 즐기는 일. 또는 그렇게 노는 일.
풍모	ㅍㅜㅇㅁㅗ	풍채와 용모.
풍미	ㅍㅜㅇㅁㅣ	음식의 고급스러운 맛.
풍수	ㅍㅜㅇㅅㅜ	바람과 물.
풍요	ㅍㅜㅇㅇㅛ	매우 많아서 넉넉함.
풍자	ㅍㅜㅇㅈㅏ	남의 부족한 점을 다른 것에 빗대어 비웃으면서 폭로하고 공격함.
풍조	ㅍㅜㅇㅈㅗ	바람과 바닷물. 또는 바람에 따라 흐르는 바닷물.
풍차	ㅍㅜㅇㅊㅏ	바람의 힘으로 날개를 회전시켜 생기는 힘을 이용하는 장치.
풍토	ㅍㅜㅇㅌㅗ	어떤 지역의 기후와 토지의 상태.
풍파	ㅍㅜㅇㅍㅏ	세찬 바람과 험한 물결.
퓨전	ㅍㅠㅈㅓㄴ	서로 다른 두 종류 이상의 것을 섞어 새롭게 만든 것.
피격	ㅍㅣㄱㅕㄱ	갑자기 누군가에게 맞거나 총, 대포, 미사일 등의 공격을 받음.
피곤	ㅍㅣㄱㅗㄴ	몸이나 마음이 지쳐서 힘듦.
피골	ㅍㅣㄱㅗㄹ	살가죽과 뼈.
피난	ㅍㅣㄴㅏㄴ	전쟁, 자연재해 등의 재난을 피해 멀리 도망감.
피동	ㅍㅣㄷㅗㅇ	스스로 움직이지 않고 남의 힘에 의해 움직임.
피란	ㅍㅣㄹㅏㄴ	전쟁이나 난리 등을 피해 멀리 도망감.
피랍	ㅍㅣㄹㅏㅂ	납치를 당함.
피력	ㅍㅣㄹㅕㄱ	생각하는 것을 숨김없이 말함.
피륙	ㅍㅣㄹㅠㄱ	아직 자르지 않은 베, 무명, 비단 등의 천.
피망	ㅍㅣㅁㅏㅇ	짧은 타원형의, 매운맛이 별로 없는 고추.
피멍	ㅍㅣㅁㅓㅇ	피부 속에 핏줄이 터져서 피가 엉긴 덩이.
피복	ㅍㅣㅂㅗㄱ	사람의 몸을 가리고 더위나 추위 등으로부터 보호하며 멋을 내기 위하여 입는 것.
피살	ㅍㅣㅅㅏㄹ	죽임을 당함.
피습	ㅍㅣㅅㅡㅂ	갑자기 공격을 받음.
피신	ㅍㅣㅅㅣㄴ	위험을 피해 안전한 곳으로 몸을 숨김.
피읖	ㅍㅣㅇㅡㅍ	한글 자모 ‘ㅍ’의 이름.
피의	ㅍㅣㅇㅡㅣ	범죄를 저질렀을 가능성이 있다는 의심을 받음.
피임	ㅍㅣㅇㅣㅁ	임신을 피함.
피칭	ㅍㅣㅊㅣㅇ	야구에서, 투수가 타자를 향해 공을 던지는 일.
피클	ㅍㅣㅋㅡㄹ	오이, 양배추 등의 채소나 과일 등을 식초, 설탕, 소금, 향신료를 섞어 만든 액체에 담아 절여서 만든 음식.
피폐	ㅍㅣㅍㅕㅣ	지치고 힘이 약해짐.
피폭	ㅍㅣㅍㅗㄱ	사람의 몸이 방사능에 노출됨.
피해	ㅍㅣㅎㅏㅣ	생명이나 신체, 재산, 명예 등에 손해를 입음. 또는 그 손해.
피혁	ㅍㅣㅎㅕㄱ	가공하지 않은 날가죽과 매만져서 부드럽게 만든 가죽.
핀트	ㅍㅣㄴㅌㅡ	카메라나 안경 등의 렌즈의 초점.
필기	ㅍㅣㄹㄱㅣ	글씨를 씀.
필두	ㅍㅣㄹㄷㅜ	나열하여 적거나 말할 때, 맨 처음에 오는 사람이나 단체.
필드	ㅍㅣㄹㄷㅡ	골프나 야구, 축구, 멀리뛰기 등의 운동 경기를 할 수 있게 만든, 넓은 장소.
필부	ㅍㅣㄹㅂㅜ	한 사람의 남자.
필사	ㅍㅣㄹㅅㅏ	죽기를 각오하고 힘을 다함.
필수	ㅍㅣㄹㅅㅜ	반드시 배우거나 공부하여 마쳐야 함.
필요	ㅍㅣㄹㅇㅛ	꼭 있어야 함.
필자	ㅍㅣㄹㅈㅏ	글을 쓴 사람. 또는 글을 쓰고 있거나 쓸 사람.
필치	ㅍㅣㄹㅊㅣ	그림이나 글씨의 획에서 나타나는 멋.
필터	ㅍㅣㄹㅌㅓ	액체나 기체 속에 든 이물질을 걸러 내는 장치.
핏기	ㅍㅣㅅㄱㅣ	사람의 피부에 보이는 불그스레한 피의 기운.
핑크	ㅍㅣㅇㅋㅡ	붉은색과 흰색이 섞인 색.
하강	ㅎㅏㄱㅏㅇ	높은 곳에서 아래를 향하여 내려옴.
하계	ㅎㅏㄱㅕㅣ	천상계에 상대하여, 사람이 사는 세상.
하급	ㅎㅏㄱㅡㅂ	낮은 등급이나 계급.
하늘	ㅎㅏㄴㅡㄹ	땅 위로 펼쳐진 무한히 넓은 공간.
하단	ㅎㅏㄷㅏㄴ	여러 단으로 된 것의 아래쪽 단.
하달	ㅎㅏㄷㅏㄹ	더 높은 기관이나 윗사람의 명령, 지시, 결정 등을 보다 낮은 기관이나 아랫사람에게 내리거나 전달함.
하대	ㅎㅏㄷㅏㅣ	상대방을 낮게 대우함.
하등	ㅎㅏㄷㅡㅇ	등급을 상, 하 또는 상, 중, 하로 나누었을 때 가장 아래인 등급.
하락	ㅎㅏㄹㅏㄱ	값이나 가치, 등급 등이 떨어짐.
하례	ㅎㅏㄹㅕㅣ	어떤 일을 축하하여 정식으로 인사를 드림.
하명	ㅎㅏㅁㅕㅇ	(높이는 말로) 명령.
하문	ㅎㅏㅁㅜㄴ	윗사람이 아랫사람에게 물음.
하복	ㅎㅏㅂㅗㄱ	여름철에 입는 옷.
하산	ㅎㅏㅅㅏㄴ	산에서 내려오거나 내려감.
하선	ㅎㅏㅅㅓㄴ	배에서 내림.
하숙	ㅎㅏㅅㅜㄱ	방세와 밥값을 내고 남의 집에 머물면서 먹고 잠. 또는 그런 집.
하순	ㅎㅏㅅㅜㄴ	한 달 가운데 21일부터 마지막 날까지의 기간.
하양	ㅎㅏㅇㅑㅇ	하얀 빛깔이나 물감.
하역	ㅎㅏㅇㅕㄱ	짐을 싣고 내리는 일.
하위	ㅎㅏㅇㅜㅣ	낮은 위치나 지위.
하의	ㅎㅏㅇㅡㅣ	몸의 아래쪽에 입는 옷.
하인	ㅎㅏㅇㅣㄴ	남의 집에 매여 살며 일을 하는 사람.
하중	ㅎㅏㅈㅜㅇ	어떤 물체나 짐 등의 무게.
하직	ㅎㅏㅈㅣㄱ	먼 길을 떠날 때 웃어른께 작별을 고하는 인사.
하천	ㅎㅏㅊㅓㄴ	강과 시내.
하청	ㅎㅏㅊㅓㅇ	어떤 사람이 일정한 계약에 따라 맡은 일의 전부나 일부를 다시 다른 사람이 맡는 것.
하체	ㅎㅏㅊㅓㅣ	사람의 몸이나 물체의 아랫부분.
하층	ㅎㅏㅊㅡㅇ	어떤 층보다 아래에 있는 층.
하편	ㅎㅏㅍㅕㄴ	상하, 또는 상중하로 나뉜 책이나 글의 끝 편.
하품	ㅎㅏㅍㅜㅁ	졸리거나 피곤하거나 배부르거나 할 때, 저절로 입이 크게 벌어지면서 하는 깊은 호흡.
하한	ㅎㅏㅎㅏㄴ	위아래로 일정한 범위를 이루고 있을 때, 아래쪽의 한계.
하향	ㅎㅏㅎㅑㅇ	아래쪽으로 향함. 또는 아래쪽.
학교	ㅎㅏㄱㄱㅛ	일정한 목적, 교과 과정, 제도 등에 의하여 교사가 학생을 가르치는 기관.
학기	ㅎㅏㄱㄱㅣ	한 학년 동안을 학업의 필요에 따라 구분한 기간.
학도	ㅎㅏㄱㄷㅗ	학교에 다니면서 공부하는 사람.
학보	ㅎㅏㄱㅂㅗ	학술 성과에 대해 기관이나 학회에서 발행하는 학술지.
학부	ㅎㅏㄱㅂㅜ	대학원과 상대하여 쓰는 말로, 대학.
학비	ㅎㅏㄱㅂㅣ	학교에 다니고 공부를 하는 데에 드는 비용.
학사	ㅎㅏㄱㅅㅏ	학술 연구에 온 힘을 기울이는 사람.
학우	ㅎㅏㄱㅇㅜ	학교에서 같이 공부하는 친구.
학자	ㅎㅏㄱㅈㅏ	특정 학문을 아주 잘 아는 사람. 또는 학문을 연구하는 사람.
학파	ㅎㅏㄱㅍㅏ	학문적 주장이나 견해가 같거나 비슷한 사람들의 집단.
한기	ㅎㅏㄴㄱㅣ	추운 기운.
한도	ㅎㅏㄴㄷㅗ	그 이상을 넘지 않도록 정해진 정도나 범위.
한로	ㅎㅏㄴㄹㅗ	찬 이슬이 내리기 시작한다는 때로 이십사절기의 하나. 10월 8일경이다.
한류	ㅎㅏㄴㄹㅠ	극에 가까운 지역에서 적도 쪽으로 흐르는, 온도가 낮은 바닷물의 흐름.
한미	ㅎㅏㄴㅁㅣ	한국과 미국.
한서	ㅎㅏㄴㅅㅓ	추위와 더위.
한시	ㅎㅏㄴㅅㅣ	같은 시각.
한우	ㅎㅏㄴㅇㅜ	누런 갈색의 우리나라 토종 소.
한자	ㅎㅏㄴㅈㅏ	중국에서 만들어 오늘날에도 쓰고 있는 중국 고유의 문자.
한지	ㅎㅏㄴㅈㅣ	추운 지방이나 장소.
한치	ㅎㅏㄴㅊㅣ	몸이 가늘고 길며 뒤 끝에 마름모 모양의 지느러미가 있고 다리가 짧은, 오징어의 한 종류.
한파	ㅎㅏㄴㅍㅏ	겨울철에 갑자기 기온이 내려가는 것.
할미	ㅎㅏㄹㅁㅣ	(낮춤말로) 할멈.
할부	ㅎㅏㄹㅂㅜ	돈을 여러 번에 나누어 냄.
함구	ㅎㅏㅁㄱㅜ	입을 다물고, 말하지 않음.
함수	ㅎㅏㅁㅅㅜ	두 개의 변수 사이에서, 하나의 변수의 값이 변하는 데 따라서 다른 변수의 값이 정해짐을 나타내는 수식.
함유	ㅎㅏㅁㅇㅠ	물질이 어떤 성분을 갖고 있음.
함자	ㅎㅏㅁㅈㅏ	(높이는 말로) 남의 이름.
함지	ㅎㅏㅁㅈㅣ	나무로 네모나게 만든 그릇.
합류	ㅎㅏㅂㄹㅠ	여러 물줄기가 하나로 모여 흐름. 또는 그 물줄기.
합리	ㅎㅏㅂㄹㅣ	논리나 이치에 알맞음.
합주	ㅎㅏㅂㅈㅜ	두 가지 이상의 악기로 동시에 연주함. 또는 그런 연주.
합치	ㅎㅏㅂㅊㅣ	의견, 주장, 생각 등이 서로 어긋나지 않고 정확히 맞음.
항거	ㅎㅏㅇㄱㅓ	순순히 따르지 않고 맞서서 대들거나 반대함.
항고	ㅎㅏㅇㄱㅗ	법원의 결정이나 명령을 따르지 않고, 다시 재판을 요구하는 일. 또는 그런 절차.
항구	ㅎㅏㅇㄱㅜ	배가 드나들 수 있도록 강가나 바닷가에 만든 시설.
항로	ㅎㅏㅇㄹㅗ	배가 바다 위에서 지나다니는 길.
항소	ㅎㅏㅇㅅㅗ	민사나 형사 소송에서 판결을 받아들이지 않고 다시 재판할 것을 요구함. 또는 그러한 일.
항시	ㅎㅏㅇㅅㅣ	보통 때.
해고	ㅎㅏㅣㄱㅗ	일터에서 일하던 사람을 그만두게 하여 내보냄.
해녀	ㅎㅏㅣㄴㅕ	바닷속에 들어가 해삼, 전복, 미역 등을 따는 일을 직업으로 하는 여자.
해로	ㅎㅏㅣㄹㅗ	바다에서 배가 다니는 길.
해류	ㅎㅏㅣㄹㅠ	일정한 방향과 빠르기로 이동하는 바닷물의 흐름.
해마	ㅎㅏㅣㅁㅏ	몸길이는 8cm 정도이며 머리는 말의 머리와 비슷하고 주둥이가 대롱 모양으로 생긴 바닷물고기.
해머	ㅎㅏㅣㅁㅓ	물건을 두드리는 데 쓰는, 쇠로 된 큰 망치.
해부	ㅎㅏㅣㅂㅜ	생물체의 한 부분 또는 전부를 갈라 그 내부를 조사함.
해소	ㅎㅏㅣㅅㅗ	어려운 일이나 좋지 않은 상태를 해결하여 없애 버림.
해수	ㅎㅏㅣㅅㅜ	맛이 짜고 비릿한, 바다에 있는 물.
해이	ㅎㅏㅣㅇㅣ	긴장이나 지켜야 할 규율 등이 풀려 마음이 느슨함.
해저	ㅎㅏㅣㅈㅓ	바다의 밑바닥.
해조	ㅎㅏㅣㅈㅗ	미역, 김, 다시마 등과 같이 바다에서 나며 포자로 번식하는 식물.
해지	ㅎㅏㅣㅈㅣ	계약을 한 한쪽이 계약으로 성립된 관계를 취소함.
해초	ㅎㅏㅣㅊㅗ	바다에서 나며 씨로 번식하는 식물.
해커	ㅎㅏㅣㅋㅓ	컴퓨터 시스템을 다루는 데 뛰어난 실력을 갖추어 다른 사람의 컴퓨터 시스템에 침입하여 저장된 정보나 프로그램을 없애거나 망치는 사람. 또는 이를 막는 사람.
해후	ㅎㅏㅣㅎㅜ	오랫동안 헤어졌다가 뜻밖에 다시 만남.
향가	ㅎㅑㅇㄱㅏ	신라 중기부터 고려 초기에 걸쳐 불렸던 한국 고유의 시가.
향기	ㅎㅑㅇㄱㅣ	좋은 냄새.
향로	ㅎㅑㅇㄹㅗ	향을 피우는 작은 화로.
향료	ㅎㅑㅇㄹㅛ	향기를 내는 데 쓰는 재료.
향수	ㅎㅑㅇㅅㅜ	몸이나 옷 등에 뿌리는, 향기가 나는 액체.
향유	ㅎㅑㅇㅇㅠ	좋은 것을 가져서 누림.
향토	ㅎㅑㅇㅌㅗ	자기가 태어나서 자란 땅.
향후	ㅎㅑㅇㅎㅜ	이것의 바로 뒤에 이어져 오는 때나 차례.
허공	ㅎㅓㄱㅗㅇ	아무것도 없는 텅 빈 공중.
허들	ㅎㅓㄷㅡㄹ	육상 경기의 장애물 달리기에 쓰는, 나무나 금속으로 만든 기구.
허락	ㅎㅓㄹㅏㄱ	요청하는 일을 하도록 들어줌.
허례	ㅎㅓㄹㅕㅣ	정성이 없이 겉으로만 화려하게 꾸밈. 또는 그런 예절.
허망	ㅎㅓㅁㅏㅇ	거짓되고 믿음이 가지 않음.
허물	ㅎㅓㅁㅜㄹ	살갗에서 저절로 일어나는 얇은 껍질.
허방	ㅎㅓㅂㅏㅇ	땅바닥이 움푹 패어 빠지기 쉬운 구덩이.
허상	ㅎㅓㅅㅏㅇ	실제로 없는 것이 있는 것처럼 보이거나 실제와 다르게 보이는 모습.
허세	ㅎㅓㅅㅓㅣ	실속이 없이 겉으로만 부풀려 보이는 기세.
허식	ㅎㅓㅅㅣㄱ	실속이 없이 겉만 꾸밈.
허실	ㅎㅓㅅㅣㄹ	허한 것과 실한 것.
허약	ㅎㅓㅇㅑㄱ	힘이나 기운이 없고 약함.
허영	ㅎㅓㅇㅕㅇ	자기의 분수에 넘치고 실속이 없이 겉을 화려하게 꾸미는 것.
허욕	ㅎㅓㅇㅛㄱ	헛된 욕심.
허용	ㅎㅓㅇㅛㅇ	문제 삼지 않고 허락하여 받아들임.
허울	ㅎㅓㅇㅜㄹ	실속이 없는 겉모습.
허위	ㅎㅓㅇㅜㅣ	진실이 아닌 것을 진실인 것처럼 꾸민 것.
허점	ㅎㅓㅈㅓㅁ	충분하지 않거나 빈틈이 있는 점.
허탈	ㅎㅓㅌㅏㄹ	몸의 기운이 빠지고 정신이 멍함. 또는 그런 상태.
허탕	ㅎㅓㅌㅏㅇ	어떤 일을 시도했다가 얻은 것이 없이 일을 끝냄. 또는 그렇게 끝낸 일.
허풍	ㅎㅓㅍㅜㅇ	실제보다 지나치게 부풀려 믿기 어려운 말이나 행동.
험구	ㅎㅓㅁㄱㅜ	남을 헐뜯는 말이나 욕을 함. 또는 그 욕.
험로	ㅎㅓㅁㄹㅗ	다니기 어려울 만큼 사납고 위험한 길.
혁파	ㅎㅕㄱㅍㅏ	오래된 기구, 제도, 법 등을 없앰.
현모	ㅎㅕㄴㅁㅗ	마음이 너그럽고 슬기로운 어머니.
현무	ㅎㅕㄴㅁㅜ	네 방위를 맡은 신 중 하나로 북쪽을 지키는 신령을 상징하는, 거북과 뱀이 뭉친 모습을 한 동물.
현미	ㅎㅕㄴㅁㅣ	벼의 겉껍질만 벗겨 낸, 누르스름한 쌀.
현자	ㅎㅕㄴㅈㅏ	지혜롭고 현명한 사람.
현지	ㅎㅕㄴㅈㅣ	사물이 현재 있는 곳.
현하	ㅎㅕㄴㅎㅏ	현재의 상황이나 형편 아래.
혈기	ㅎㅕㄹㄱㅣ	힘을 쓰고 활동하게 하는 기운.
혈류	ㅎㅕㄹㄹㅠ	혈관 속의 피의 흐름.
혈서	ㅎㅕㄹㅅㅓ	굳은 결심이나 맹세 등을 나타내기 위해 스스로 상처를 내어 피로 글을 씀. 또는 그 글.
혈투	ㅎㅕㄹㅌㅜ	죽음을 무릅쓰고 사납고 힘들게 하는 싸움.
혐오	ㅎㅕㅁㅇㅗ	싫어하고 미워함.
협조	ㅎㅕㅂㅈㅗ	힘을 보태어 도움.
협주	ㅎㅕㅂㅈㅜ	독주 악기와 관현악이 함께 연주할 때 독주 악기의 기교가 돋보이게 연주함. 또는 그런 연주.
형기	ㅎㅕㅇㄱㅣ	형벌을 받는 기간.
형부	ㅎㅕㅇㅂㅜ	언니의 남편을 이르거나 부르는 말.
형사	ㅎㅕㅇㅅㅏ	형법의 적용을 받는 사건.
형수	ㅎㅕㅇㅅㅜ	가족이나 친척 사이에서 형의 아내를 이르거나 부르는 말.
호각	ㅎㅗㄱㅏㄱ	입으로 불어서 소리를 내어 신호를 보내는 데에 쓰는 도구.
호감	ㅎㅗㄱㅏㅁ	어떤 대상에 대하여 느끼는 좋은 감정.
호강	ㅎㅗㄱㅏㅇ	풍족하고 편안한 생활을 함. 또는 그런 생활.
호걸	ㅎㅗㄱㅓㄹ	지혜와 용기가 뛰어나고 굳세고 큰 뜻을 품은 사람.
호격	ㅎㅗㄱㅕㄱ	문장에서 체언이 독립적으로 쓰여 부르는 말의 역할을 하게 하는 격.
호국	ㅎㅗㄱㅜㄱ	나라를 지키고 보호함.
호남	ㅎㅗㄴㅏㅁ	남자답고 씩씩하며 외모가 훌륭한 남자.
호령	ㅎㅗㄹㅕㅇ	부하나 동물을 지휘하여 명령함. 또는 그 명령.
호른	ㅎㅗㄹㅡㄴ	활짝 핀 나팔꽃 모양으로 소리가 부드러운 금관 악기.
호명	ㅎㅗㅁㅕㅇ	이름을 부름.
호박	ㅎㅗㅂㅏㄱ	잎이 크고 종 모양의 노란 꽃이 피며 크고 둥근 열매를 맺는 덩굴풀.
호반	ㅎㅗㅂㅏㄴ	호수를 둘러싼 가장자리.
호봉	ㅎㅗㅂㅗㅇ	직위나 근무한 공로에 따라 정해지는 급여의 등급.
호상	ㅎㅗㅅㅏㅇ	복을 누리고 오래 산 사람이 죽는 일.
호송	ㅎㅗㅅㅗㅇ	목적지까지 보호하여 옮김.
호실	ㅎㅗㅅㅣㄹ	일정한 번호가 매겨진 방.
호언	ㅎㅗㅇㅓㄴ	어떤 목적을 이루겠다고 씩씩하게 하는 말.
호외	ㅎㅗㅇㅗㅣ	특별한 사건이 있을 때 임시로 내는 신문이나 잡지.
호위	ㅎㅗㅇㅜㅣ	어떤 대상을 곁에서 보호하고 지킴.
호응	ㅎㅗㅇㅡㅇ	상대방의 부름이나 물음에 대답하거나 요구에 맞춰 행동함.
호의	ㅎㅗㅇㅡㅣ	친절한 마음씨. 또는 어떤 대상을 좋게 생각하는 마음.
호인	ㅎㅗㅇㅣㄴ	성격 또는 인품이 좋은 사람.
호재	ㅎㅗㅈㅏㅣ	좋은 기회나 조건.
호적	ㅎㅗㅈㅓㄱ	한 집안의 주인을 중심으로 그 집에 속한 사람들의 신분에 관한 내용을 기록한 공식적인 문서.
호전	ㅎㅗㅈㅓㄴ	일의 형편이나 상황이 좋은 방향으로 바뀜.
호청	ㅎㅗㅊㅓㅇ	→ 홑청
호출	ㅎㅗㅊㅜㄹ	전화나 전신 등을 통해 상대방을 부르는 일.
호칭	ㅎㅗㅊㅣㅇ	이름을 지어 부름. 또는 그 이름.
호통	ㅎㅗㅌㅗㅇ	몹시 화가 나서 크게 소리를 지르거나 꾸짖음. 또는 그 소리.
호평	ㅎㅗㅍㅕㅇ	좋게 평함. 또는 그런 평가.
호혜	ㅎㅗㅎㅕㅣ	서로 특별한 혜택을 주고받는 일.
호화	ㅎㅗㅎㅗㅏ	사치스럽고 화려함.
호흡	ㅎㅗㅎㅡㅂ	숨을 쉼. 또는 그 숨.
혹사	ㅎㅗㄱㅅㅏ	몹시 심하게 일을 시킴.
혹서	ㅎㅗㄱㅅㅓ	몹시 심한 더위.
혹자	ㅎㅗㄱㅈㅏ	어떤 사람.
혼기	ㅎㅗㄴㄱㅣ	결혼을 하기에 알맞은 나이.
혼미	ㅎㅗㄴㅁㅣ	의식이 흐림. 또는 그런 상태.
혼사	ㅎㅗㄴㅅㅏ	혼인에 관한 일. 또는 혼인하는 일.
혼수	ㅎㅗㄴㅅㅜ	정신없이 잠이 듦.
혼자	ㅎㅗㄴㅈㅏ	다른 사람 없이 한 사람.
혼처	ㅎㅗㄴㅊㅓ	혼인할 자리. 또는 혼인하기에 알맞은 자리.
홀수	ㅎㅗㄹㅅㅜ	2로 나누어서 나머지 1이 남는 수.
홍보	ㅎㅗㅇㅂㅗ	널리 알림. 또는 그 소식.
홍수	ㅎㅗㅇㅅㅜ	비가 많이 내려서 갑자기 크게 불어난 강이나 개천의 물.
홍시	ㅎㅗㅇㅅㅣ	잘 익어 붉고 물렁물렁한 감.
홍어	ㅎㅗㅇㅇㅓ	몸의 길이가 1.5미터 정도로 크며, 마름모 모양으로 납작하게 생긴 바닷물고기.
홍조	ㅎㅗㅇㅈㅗ	아침 해가 바다에 비쳐 붉게 물든 경치.
홍차	ㅎㅗㅇㅊㅏ	차나무의 잎을 발효시켜 말린 것으로, 끓는 물에 넣으면 맑은 붉은색을 띠고 향기가 나는 차.
화가	ㅎㅗㅏㄱㅏ	그림을 전문적으로 그리는 사람.
화교	ㅎㅗㅏㄱㅛ	외국에서 사는 중국 사람.
화기	ㅎㅗㅏㄱㅣ	불에서 나오는 뜨거운 기운.
화두	ㅎㅗㅏㄷㅜ	이야기의 첫머리.
화로	ㅎㅗㅏㄹㅗ	불씨가 꺼지지 않도록 지키거나 방을 따뜻하게 하기 위해 숯불을 담아 놓는 그릇.
화보	ㅎㅗㅏㅂㅗ	무엇을 그림으로 그리거나 사진으로 찍어서 인쇄한 종이나 책.
화자	ㅎㅗㅏㅈㅏ	이야기를 하는 사람.
화초	ㅎㅗㅏㅊㅗ	꽃이 피는 풀과 나무. 또는 두고 보면서 즐기는 모든 식물.
화투	ㅎㅗㅏㅌㅜ	일 년 열두 달과 사계절을 나타내는 그림이 있는 48장으로 된 놀이용 딱지.
화포	ㅎㅗㅏㅍㅗ	대포처럼 화약의 힘으로 탄환을 쏘는 무기.
회고	ㅎㅗㅣㄱㅗ	지나간 일을 돌이켜 생각함.
회교	ㅎㅗㅣㄱㅛ	7세기 초 아라비아의 예언자 마호메트가 창시하였으며, 유일신 알라를 모시고 코란을 경전으로 하는, 세계 3대 종교의 하나.
회기	ㅎㅗㅣㄱㅣ	회의를 시작하여 마칠 때까지의 기간.
회보	ㅎㅗㅣㅂㅗ	모임에 관한 일을 그 모임의 회원들에게 알리는 보고. 또는 그런 간행물.
회부	ㅎㅗㅣㅂㅜ	어떤 문제나 서류, 사건 등을 관계 기관이나 회의, 재판 등에 돌려보내거나 넘김.
회비	ㅎㅗㅣㅂㅣ	모임에서 사용하기 위하여 그 모임의 회원들이 내는 돈.
회사	ㅎㅗㅣㅅㅏ	사업을 통해 이익을 얻기 위해 여러 사람이 모여 만든 법인 단체.
회수	ㅎㅗㅣㅅㅜ	내주었거나 빌려주었던 것을 도로 거두어들임.
회유	ㅎㅗㅣㅇㅠ	어르고 달래어 시키는 말을 듣도록 함.
회자	ㅎㅗㅣㅈㅏ	칭찬을 받으며 사람의 입에 자주 오르내림.
회포	ㅎㅗㅣㅍㅗ	마음속에 품은 생각이나 정.
회피	ㅎㅗㅣㅍㅣ	만나지 않고 피함.
효과	ㅎㅛㄱㅗㅏ	어떠한 것을 하여 얻어지는 좋은 결과.
효능	ㅎㅛㄴㅡㅇ	좋은 결과를 나타내는 능력.
효력	ㅎㅛㄹㅕㄱ	약 등을 사용한 뒤에 얻는 좋은 결과.
효성	ㅎㅛㅅㅓㅇ	부모를 잘 모시어 받드는 정성.
효심	ㅎㅛㅅㅣㅁ	부모를 잘 모시어 받드는 마음.
효용	ㅎㅛㅇㅛㅇ	좋은 결과를 내거나 만족감이 있게 쓰거나 쓰임.
효율	ㅎㅛㅇㅠㄹ	들인 노력이나 힘에 대한 결과의 비율.
효험	ㅎㅛㅎㅓㅁ	어떤 일이나 작용의 좋은 보람이나 결과.
후각	ㅎㅜㄱㅏㄱ	코로 냄새를 맡는 감각.
후계	ㅎㅜㄱㅕㅣ	어떤 일이나 사람의 뒤를 이음.
후궁	ㅎㅜㄱㅜㅇ	왕이 아내 외에 데리고 사는 여자.
후년	ㅎㅜㄴㅕㄴ	올해의 다음다음 해.
후대	ㅎㅜㄷㅏㅣ	후하게 잘 대접함. 또는 그런 대접.
후덕	ㅎㅜㄷㅓㄱ	말과 행동, 성품 등이 어질고 덕이 후함.
후렴	ㅎㅜㄹㅕㅁ	시에서, 각 절의 끝에 되풀이되는 같은 시구.
후면	ㅎㅜㅁㅕㄴ	뒤쪽 면.
후문	ㅎㅜㅁㅜㄴ	방이나 건물의 뒤에 있는 문.
후반	ㅎㅜㅂㅏㄴ	전체를 반씩 둘로 나눈 것의 뒤쪽 반.
후발	ㅎㅜㅂㅏㄹ	남보다 늦게 어떤 일을 시작해 뒤따라감.
후방	ㅎㅜㅂㅏㅇ	뒤를 향한 방향.
후배	ㅎㅜㅂㅏㅣ	같은 분야에서 자기보다 늦게 일을 시작한 사람.
후불	ㅎㅜㅂㅜㄹ	일이 끝난 뒤나 물건을 받은 뒤에 돈을 냄.
후세	ㅎㅜㅅㅓㅣ	다음에 오는 세상. 또는 다음 세대의 사람들.
후속	ㅎㅜㅅㅗㄱ	뒤를 이어 계속함.
후손	ㅎㅜㅅㅗㄴ	자신의 세대에서 여러 세대가 지난 뒤의 자녀.
후송	ㅎㅜㅅㅗㅇ	전투가 벌어지고 있는 곳에서 부상자, 물자, 포로 등을 뒤에 있는 지역으로 보냄.
후식	ㅎㅜㅅㅣㄱ	식사 후에 먹는 간단한 음식.
후실	ㅎㅜㅅㅣㄹ	(높이는 말로) 다른 사람이 재혼하여 얻은 아내.
후예	ㅎㅜㅇㅕㅣ	자신의 세대에서 여러 세대가 지난 뒤의 자녀.
후위	ㅎㅜㅇㅜㅣ	뒤쪽의 호위나 방위.
후일	ㅎㅜㅇㅣㄹ	시간이 지나고 앞으로 올 날.
후임	ㅎㅜㅇㅣㅁ	전에 일을 맡아보던 사람에 뒤이어 일을 맡음. 또는 그런 사람이나 그 일.
후진	ㅎㅜㅈㅣㄴ	어떤 발전 수준에 뒤떨어짐. 또는 그런 사람.
후퇴	ㅎㅜㅌㅗㅣ	뒤로 물러남.
후편	ㅎㅜㅍㅕㄴ	두 편으로 나뉘어 있는 책이나 영화 등의 뒤쪽 편.
후학	ㅎㅜㅎㅏㄱ	어떤 학문을 자기보다 늦게 연구하기 시작한 사람.
후회	ㅎㅜㅎㅗㅣ	이전에 자신이 한 일이 잘못임을 깨닫고 스스로 자신의 잘못을 꾸짖음.
훈기	ㅎㅜㄴㄱㅣ	훈훈한 기운.
훈수	ㅎㅜㄴㅅㅜ	바둑이나 장기 등을 둘 때 구경하던 사람이 끼어들어 수를 가르쳐 줌.
훈시	ㅎㅜㄴㅅㅣ	윗사람이 아랫사람에게 맡은 일을 처리할 때에 주의할 점을 일러 줌.
휘하	ㅎㅜㅣㅎㅏ	장군의 지휘 아래. 또는 그 지휘를 따르는 사람.
휴강	ㅎㅠㄱㅏㅇ	강의를 하지 않고 쉼.
휴게	ㅎㅠㄱㅓㅣ	어떤 일을 하다가 잠깐 동안 쉼.
휴대	ㅎㅠㄷㅏㅣ	어떤 물건을 손에 들거나 몸에 지니고 다님.
휴면	ㅎㅠㅁㅕㄴ	쉬면서 거의 아무런 활동도 하지 않음.
휴식	ㅎㅠㅅㅣㄱ	하던 일을 멈추고 잠시 쉼.
휴양	ㅎㅠㅇㅑㅇ	편안히 쉬면서 건강을 잘 돌봄.
휴업	ㅎㅠㅇㅓㅂ	사업이나 영업, 작업 등을 잠시 중단하고 하루 또는 한동안 쉼.
휴일	ㅎㅠㅇㅣㄹ	일요일이나 공휴일 등과 같이 일을 하지 않고 쉬는 날.
휴전	ㅎㅠㅈㅓㄴ	전쟁을 일정한 기간 동안 멈추는 일.
휴정	ㅎㅠㅈㅓㅇ	법원에서, 재판을 잠시 쉬는 일.
휴직	ㅎㅠㅈㅣㄱ	일정한 기간 동안 직장에서 맡은 일을 쉼.
휴진	ㅎㅠㅈㅣㄴ	병원이나 의사가 일정한 기간 동안 진료를 하지 않고 쉼.
휴학	ㅎㅠㅎㅏㄱ	일정한 기간 동안 학교를 쉬는 일.
흉가	ㅎㅠㅇㄱㅏ	사는 사람마다 좋지 않은 일을 당하는 불길한 집.
흉기	ㅎㅠㅇㄱㅣ	사람을 죽이거나 해치는 데 쓰는 도구.
흉부	ㅎㅠㅇㅂㅜ	인간이나 동물의 목과 배 사이에 있는 몸의 앞부분.
흉조	ㅎㅠㅇㅈㅗ	나쁜 일이 생길 징조.
흉터	ㅎㅠㅇㅌㅓ	상처가 아물고 남은 자국.
흉포	ㅎㅠㅇㅍㅗ	성질이 매우 흉악하고 포악함.
흐름	ㅎㅡㄹㅡㅁ	흐르는 것.
흑자	ㅎㅡㄱㅈㅏ	번 돈이 쓴 돈보다 많아 이익이 생김.
흠모	ㅎㅡㅁㅁㅗ	기쁜 마음으로 존경하고 마음속 깊이 따름.
흡수	ㅎㅡㅂㅅㅜ	안이나 속으로 빨아들임.
흥미	ㅎㅡㅇㅁㅣ	마음을 쏠리게 하는 재미.
흥부	ㅎㅡㅇㅂㅜ	고대 소설 ‘흥부전’의 주인공. 심술궂은 형 놀부와 달리 착한 마음씨를 지녔다. 부러진 제비 다리를 고쳐 준 인연으로 큰 부자가 된다.
희구	ㅎㅡㅣㄱㅜ	바라고 구함.
희비	ㅎㅡㅣㅂㅣ	기쁨과 슬픔.
희소	ㅎㅡㅣㅅㅗ	매우 드물고 적음.
희수	ㅎㅡㅣㅅㅜ	일흔일곱 살.
히읗	ㅎㅣㅇㅡㅎ	한글 자모 ‘ㅎ’의 이름.
힌트	ㅎㅣㄴㅌㅡ	문제를 풀거나 일을 해결하는 데 도움이 되는 것.
